Jahr	das
Mark	die
Zeit	die
Uhr	die
Mann	der
Haus	das
Frau	die
Land	das
Stadt	die
Tag	der
Platz	der
Million	die
Ende	das
Mensch	der
Kind	das
Punkt	der
Polizei	die
Fall	das
Arbeit	die
Problem	das
Gruppe	die
Regierung	die
Amt	das
Prozent	das
Geld	das
Rat	der
Politik	die
Frage	die
Partei	die
Deutschland	das
Teil	der
Minister	der
Woche	die
Grund	der
Werk	das
Seite	die
Weg	der
Bild	das
Lage	die
Spiel	das
Mitglied	das
Meister	der
Gericht	das
Markt	der
Raum	der
Stelle	die
Hilfe	die
Chef	der
Wahl	die
Thema	das
Geschichte	die
Wort	das
Staat	der
Schule	die
Plan	der
Ergebnis	das
Welt	die
Zahl	die
Preis	der
Recht	das
Kreis	der
Krieg	der
Gesetz	das
Entscheidung	die
Bereich	der
Angabe	die
Verein	der
Programm	das
Monat	der
Film	der
Gesellschaft	die
Sache	die
Bau	der
Buch	das
Kraft	die
Projekt	das
Ministerium	das
Hof	der
Satz	der
Ort	der
Milliarde	die
Sprecher	der
Betrieb	der
Dienst	der
Kampf	der
Verband	der
Aktion	die
Mittel	das
System	das
Gebiet	das
Erfolg	der
Bank	die
Vertrag	der
Anlage	die
Entwicklung	die
Familie	die
Situation	die
Name	der
Antrag	der
Zug	der
Schutz	der
Politiker	der
Wohnung	die
Herr	der
Art	die
Angebot	das
Auto	das
Republik	die
Gang	der
Fahrer	der
Hand	die
Mitarbeiter	der
Ziel	das
Bahn	die
Europa	das
Wert	der
Wirtschaft	die
Zukunft	die
Leben	das
Beispiel	das
Druck	der
Abend	der
Verwaltung	die
Kurs	der
Montag	der
Anfang	der
Opfer	das
Rolle	die
Stand	der
Veranstaltung	die
Musik	die
Bericht	der
Zeitung	die
Sonntag	der
Verkehr	der
Theater	das
Stunde	die
Person	die
Schritt	der
Organisation	die
Blick	der
Bewegung	die
Gast	der
Konzept	das
Kritik	die
Angst	die
Interesse	das
Fraktion	die
Diskussion	die
Gramm	das
Wasser	das
Vorschlag	der
Verhandlung	die
Arzt	der
Firma	die
Richtung	die
Parlament	das
Gemeinde	die
September	der
Oktober	der
Freund	der
Ausstellung	die
Dienstag	der
Richter	der
Beginn	der
Mittwoch	der
Heim	das
Minute	die
Linie	die
Januar	der
Form	die
Leiter	der
Forderung	die
Kirche	die
Halle	die
Industrie	die
Freitag	der
Fest	das
Zeug	das
November	der
Aufgabe	die
Grenze	die
Ordnung	die
Vertreter	der
Gefahr	die
Kopf	der
Tat	die
Mal	das
Mehrheit	die
Sinn	der
Vater	der
Anwalt	der
Fahrt	die
Senat	der
Mutter	die
Leistung	die
Vorstand	der
Dollar	der
August	der
Bad	das
Stoff	der
Erfahrung	die
Liste	die
Idee	die
Sitzung	die
Spieler	der
Kunst	die
Stellung	die
Dezember	der
Arbeiter	der
Rede	die
Wehr	das
Senator	der
Versammlung	die
Tisch	der
Urteil	das
Stein	der
Auge	das
Termin	der
Donnerstag	der
Waffe	die
Juli	der
Datum	das
Feld	das
Vorwurf	der
Osten	der
Anteil	der
Band	die
Tod	der
Beamter	der
Mannschaft	die
Kultur	die
Nacht	die
Besucher	der
Gewalt	die
Demokrat	der
Februar	der
Leitung	die
Szene	die
Information	die
Lager	das
Garten	der
Versuch	der
Meinung	die
Partner	der
Volk	das
Publikum	das
Kommission	die
Stimme	die
Macht	die
Gemeinschaft	die
Kohl	der
Boden	der
Gewerkschaft	die
Antwort	die
Entwurf	der
Berg	der
Sprache	die
Schrift	die
Brief	der
Sicht	die
Verfahren	das
Bauer	der
Zeichen	das
Anwaltschaft	die
Produktion	die
Technik	die
Experte	der
Polizist	der
Streit	der
Mai	der
Position	die
Anspruch	der
Reform	die
Mitte	die
Umsatz	der
Produkt	das
Region	die
Verletzung	die
Papier	das
Nummer	die
Kasse	die
Verlust	der
Unternehmen	das
Tor	das
Koalition	die
Sicherheit	die
Bedingung	die
Geber	der
Kontrolle	die
Handel	der
Truppe	die
Modell	das
Armee	die
Titel	der
Kandidat	der
Regelung	die
Folge	die
Konflikt	der
Konferenz	die
Stimmung	die
Einheit	die
Reihe	die
Blatt	das
Soldat	der
Klasse	die
Rum	der
Bund	der
Debatte	die
Einsatz	der
Schaden	der
Juni	der
Schlag	der
Streik	der
Team	das
Kontakt	der
Wand	die
Karte	die
Haltung	die
Dorf	das
Museum	das
Ball	der
Institut	das
Auftrag	der
Maschine	die
Ursache	die
Besuch	der
Ding	das
Hoffnung	die
Tier	das
Saal	der
Sieg	der
Unfall	der
Konzern	der
Bruch	der
Bewerber	der
Reich	das
Text	der
Vorstellung	die
Union	die
April	der
Konzert	das
Verbot	das
Planung	die
Kost	die
Wald	der
Licht	das
Gesicht	das
Wagen	der
Baum	der
Zustand	der
Opposition	die
Luft	die
Material	das
Krise	die
Struktur	die
Angriff	der
Hafen	der
Wunsch	der
Strafe	die
Untersuchung	die
Zentrum	das
Gegner	der
Hinweis	der
Lauf	der
Beratung	die
Student	der
Sport	der
Station	die
Tonne	die
Beteiligung	die
Fehler	der
Zuschauer	der
Bezirk	der
Menge	die
Freiheit	die
Schwierigkeit	die
Wechsel	der
Zusammenarbeit	die
Auseinandersetzung	die
Reise	die
Journalist	der
Sommer	der
Vergangenheit	die
Ausgabe	die
Autor	der
Israel	der
Kollege	der
Demokratie	die
Anschlag	der
Rad	das
Mord	der
Trainer	der
Rest	der
Beitrag	der
Beziehung	die
Bewohner	der
Lehrer	der
Quote	die
Feuer	das
Zimmer	das
Vereinigung	die
Steuer	das
Medium	das
Anstalt	die
Widerstand	der
Initiative	die
Moment	das
Prinzip	das
Bus	der
Einrichtung	die
Tochter	die
Kammer	die
Ansicht	die
Bedeutung	die
Zusammenhang	der
Sohn	der
Weise	die
Aussage	die
Haft	die
Bedarf	der
Gewinn	der
Wirkung	die
Wettbewerb	der
Brand	der
Demonstration	die
Westen	der
Kanzler	der
Mangel	die
Netz	das
Vergleich	der
Bildung	die
Telefon	das
Direktor	der
Ton	der
Rechnung	die
Schein	der
Figur	die
Afrika	das
Reaktion	die
Aufnahme	die
Pause	die
Branche	die
Paar	das
Artikel	der
Schau	die
Investition	die
Park	der
Bilanz	die
Traum	der
Zweifel	der
Hersteller	der
Presse	die
Hamburger	der
Verantwortung	die
Bayern	das
Verbindung	die
Schiff	das
Rand	der
Sitz	der
Begriff	der
Konsequenz	die
Liga	die
Spruch	der
Sender	der
Herbst	der
Ereignis	das
Motiv	das
Auskunft	die
Besitzer	der
Griff	der
Ruhe	die
Regel	die
Farbe	die
Voraussetzung	die
Risiko	das
Zeuge	die
Protest	der
Versicherung	die
Kunde	die
Bach	der
Trend	der
Fenster	das
Ermittlung	die
Anzeige	die
Gedanke	der
Strecke	die
Wende	der
Alter	das
Feier	die
Basis	die
Verkauf	der
Argument	das
Not	die
Klinik	die
Zone	die
Front	die
Abteilung	die
Praxis	die
Gott	der
Vorteil	der
Versorgung	die
Ausland	das
Pflicht	die
Fan	der
Ruf	der
Hund	der
Tradition	die
Test	der
Belastung	die
Klage	die
Professor	der
Wissenschaftler	der
Verlag	der
Finanzierung	die
Funk	der
Abstimmung	die
Einer	der
Forschung	die
Personal	das
Wahrheit	die
Kino	das
Strategie	die
Summe	die
Halt	der
Vorjahr	das
Sendung	die
Jugend	die
Serie	die
Gut	das
Runde	die
Suche	die
Betrag	der
Botschaft	die
Bestand	der
Einnahme	die
Weste	die
Phase	die
Schuld	die
Kommune	die
Morgen	der
Spur	die
Tausend	die
Befehl	der
Natur	die
Mauer	die
Vereinbarung	die
Krankheit	die
Gremium	das
Insel	die
Lunge	die
Haushalt	der
Ausbildung	die
Zustimmung	die
Patient	der
Radio	das
Jude	der
Hotel	das
Freude	die
Beirat	der
Sieger	der
Wirklichkeit	die
Methode	die
Genehmigung	die
Fabrik	die
Stiftung	die
Job	der
Katastrophe	die
Kampagne	die
Italien	das
Bereitschaft	die
Ring	der
See	der
Posten	der
Perspektive	die
Magistrat	der
Ausnahme	die
Stellungnahme	die
Post	die
Spiegel	der
Amerika	das
Amerikaner	der
Lied	das
Abbau	der
Interview	das
Gegenteil	das
Grad	der
Agentur	die
Strom	der
Computer	der
Manager	der
Stil	der
Funktion	die
Vortrag	der
Landschaft	die
Verfassung	die
Darstellung	die
Motto	das
Verdacht	der
Messe	die
Pfarrer	der
Akte	die
Sorge	die
Dauer	die
Fischer	der
Geist	der
Bruder	der
Forum	das
Flucht	die
Wirt	der
Welle	die
Kauf	der
Niveau	das
Ebene	die
Engagement	das
Heute	das
Dach	das
Studie	die
Wesen	das
Meldung	die
Beruf	der
Schild	das
Werbung	die
Objekt	das
Energie	die
Dame	die
Revolution	die
Wille	der
Erkenntnis	die
Essen	das
Widerspruch	der
Sanierung	die
Aktie	die
Setzung	die
Chor	der
Inhalt	der
Unterschied	der
Vogel	der
Pole	der
Nachbar	der
Heimat	die
Probe	die
Effekt	der
Genosse	der
Macher	der
Kommentar	der
Aber	das
Loch	das
Stuhl	der
Flug	der
Generation	die
Kritiker	der
Charakter	der
Sowjetunion	die
Teilnehmer	der
Republikaner	der
Skandal	der
Schwester	die
Redaktion	die
Behandlung	die
Himmel	der
Erwartung	die
Auflage	die
Erinnerung	die
Gabe	die
Alternative	die
Schicksal	das
Scheibe	die
Los	das
Element	das
Treffen	das
Fahrzeug	das
Wind	der
Einwohner	der
Herz	das
Kabinett	das
Unterricht	der
Kreuz	das
Angelegenheit	die
Anwohner	der
Gewicht	das
Wachstum	das
Vorbereitung	die
Kamera	die
Start	der
Regisseur	der
Wissenschaft	die
Instrument	das
Demonstrant	der
Tanz	der
Rate	die
Meisterschaft	die
Etat	der
Nachricht	die
Keller	der
Bein	das
Graf	der
Horst	der
Wetter	das
Last	die
Show	die
Musiker	der
Kanal	der
Umstand	der
Bestimmung	die
Tritt	der
Serbe	der
Aufbau	der
Literatur	die
Ausbau	der
Ware	die
Statistik	die
Erde	die
Akt	der
Umwelt	die
Komitee	das
Gas	das
Defizit	das
Betreuung	die
Kapital	das
Lust	die
Frist	die
Anfrage	die
Holz	das
Tasche	die
Stab	der
Winter	der
Nachfolger	der
Zahlung	die
Laden	der
Signal	das
Kenntnis	die
Masse	die
Mut	der
Gelegenheit	die
Anmeldung	die
Auffassung	die
Verbesserung	die
Zeile	die
Tendenz	die
Katalog	der
Vorgang	der
Kredit	der
Ansatz	der
Beobachter	der
Karriere	die
Nachfrage	die
Sammlung	die
Roman	der
Schneider	der
Leiche	die
Gehalt	der
Verteidigung	die
Entlassung	die
Unterkunft	die
Wolf	der
Bett	das
Liebe	die
Begegnung	die
Zelle	die
Umgebung	die
Ausgleich	der
Steigerung	die
Tempo	das
Stadion	das
Interessent	der
Spitze	die
Spannung	die
Beschwerde	die
Block	der
Schnitt	der
Quelle	die
Berater	der
Ladung	die
Investor	der
Magazin	das
Mieter	der
Galerie	die
Auswirkung	die
Dung	der
Stadtteil	der
Helfer	der
Pflege	die
Rahmen	der
Lohn	der
Stern	der
Turm	der
Abfall	der
Paket	das
Tourist	der
Turnier	das
Marke	die
Sturm	der
Schweizer	der
Abgabe	die
Anklage	die
Miete	die
Minderheit	die
Beweis	der
Flasche	die
Export	der
Bombe	die
Analyse	die
Bier	das
Besetzung	die
Auswahl	die
Glas	das
Verordnung	die
Zentrale	die
Kette	die
Strich	der
Teufel	der
Feind	der
Finale	das
Leser	der
Aspekt	der
Seminar	das
Kurde	der
Plakat	das
Pfennig	der
Ohr	das
Studium	das
Kern	der
Sozialismus	der
Treuhand	die
Stock	der
Verlauf	der
Friede	der
Sprung	der
Inszenierung	die
Droge	die
Eintritt	der
Hesse	der
Sachse	der
Zins	der
Umfrage	die
Teilnahme	die
Alltag	der
Prognose	die
Adresse	die
Faktor	der
Regen	der
Offizier	der
Eingang	der
Justiz	die
Meer	das
Kooperation	die
Brauch	der
Gestaltung	die
Sack	der
Vorlage	die
Mandat	das
Teilung	die
Operation	die
Rang	der
Held	der
Schicht	die
Zugang	der
Tour	die
Schuh	der
Premiere	die
Vorhaben	das
Freundin	die
Dutzend	das
Mischung	die
Ausdruck	der
Mund	der
Konto	das
Ernst	der
Austausch	der
Sonne	die
Kundgebung	die
Zelt	das
Zuwachs	der
Apparat	der
Besitz	der
Ehe	die
General	der
Oper	die
Ecke	die
Russe	der
Handlung	die
Nutzung	die
Verhalten	das
Training	das
Kneipe	die
Haut	die
Brandenburg	das
Verteidiger	der
Ensemble	das
Version	die
Rauch	der
Drohung	die
Aufwand	der
Lieferung	die
Chaos	das
Boot	das
Spanien	das
Vorfall	der
Variante	die
Dokument	das
Regime	das
Pferd	das
Haar	das
Feindlichkeit	die
Kriterium	das
Geschenk	das
Gipfel	der
Klima	das
Blut	das
Einigung	die
Berufung	die
Vorbild	das
Umbau	der
Privatisierung	die
Redakteur	der
Metall	das
Vorschrift	die
Fleisch	das
Franzose	der
Standard	der
Star	der
Architekt	der
Einzelheit	die
Volumen	das
Falle	die
Finger	der
Kompetenz	die
Stufe	die
Umzug	der
Tagung	die
Tourismus	der
Aufruf	der
Bogen	der
Wunder	das
Kommunist	der
Symbol	das
Wein	der
Absicht	die
Theorie	die
Schweiz	die
Klub	der
Iran	der
Orchester	das
Nagel	der
Aussicht	die
Laub	das
Wandel	der
Rekord	der
Anerkennung	die
Bescheid	der
Nase	die
Vertretung	die
Gasse	die
Spende	die
Experiment	das
Forscher	der
Technologie	die
Treffer	der
Spekulation	die
Durchschnitt	der
Explosion	die
Hektar	der
Typ	der
Parole	die
Konjunktur	die
Zwang	der
Arm	der
Nazi	der
Asyl	das
Akademie	die
Status	der
Existenz	die
Vision	die
Belegschaft	die
Denkmal	das
Motor	der
Messer	der
Abstand	der
Periode	die
Stahl	der
Wanderung	die
Sicherung	die
Sportler	der
Vertrauen	das
Ablehnung	die
Spitz	der
Bar	das
Geburt	die
Dieb	der
Sozialist	der
Decke	die
Hose	die
Wiese	die
Abschnitt	der
Beifall	der
Brot	das
Siedlung	die
Ersatz	der
Reaktor	der
Fisch	der
Stich	der
Tand	der
Anbieter	der
Gewerbe	das
Marsch	die
Partie	die
Witz	der
Geheimnis	das
Krause	die
Gedicht	das
Bischof	der
Anwendung	die
Hinsicht	die
Teller	der
Seele	die
Lokal	das
Verteilung	die
Referent	der
Grab	das
Index	der
Herrschaft	die
Tal	das
Schirm	der
Ausflug	der
Hubschrauber	der
Mittag	der
Erweiterung	die
Auftakt	der
Rezept	das
Rakete	die
Stopp	der
Kapelle	die
Zunge	die
Deponie	die
Bibliothek	die
Klang	der
Gymnasium	das
Gegend	die
Sponsor	der
Wissen	das
Sperre	die
Temperatur	die
Protokoll	die
Kommando	das
Ingenieur	der
Verpflichtung	die
Tarif	der
Geschwindigkeit	die
Management	das
Helm	der
Fach	das
Tafel	die
Zettel	der
Umfang	der
Anstieg	der
Muster	das
Kommunikation	die
Provinz	die
Niederlage	die
Norden	der
Kaserne	die
Jurist	der
Empfehlung	die
Rose	die
Alkohol	der
Rassismus	der
Absatz	der
Medikament	das
Tuch	das
Restaurant	das
Pistole	die
Quartier	das
Konzentration	die
Lade	die
Archiv	das
Junge	das
Kuchen	der
Platte	die
Aids	das
Abbruch	der
Einsparung	die
Tunnel	der
Abschied	der
Organ	das
Fahne	die
Konsens	der
Ausgang	der
Gift	das
Eis	das
Differenz	die
Stau	der
Allianz	die
Schreiben	das
Festnahme	die
Sektor	der
Zufall	der
Garantie	die
Furt	die
Herausforderung	die
Ablauf	der
Nachmittag	der
Profi	der
Optimismus	der
Jagd	die
Verzicht	der
Erscheinung	die
Ausstattung	die
Fassung	die
Appell	der
Wache	die
George	der
Schock	das
Japaner	der
Moral	die
Gold	das
These	die
Wut	die
Sanktion	die
Denken	das
Medaille	die
Bezug	der
Sturz	der
Verfolgung	die
Schrank	der
Aufenthalt	der
Hut	der
Vorfeld	das
Produzent	der
Mission	die
Bande	die
Gesundheit	die
Exemplar	das
Image	das
Regie	die
Uni	die
Subvention	die
Liter	der
Lehre	die
Integration	die
Rock	der
Palast	der
Trennung	die
Schwede	der
Haupt	das
Rohr	das
Architektur	die
Reserve	die
Blume	die
Planer	der
Maler	der
Note	die
Beute	die
Dimension	die
Port	der
Abzug	der
Bedenken	das
Warnung	die
Gebrauch	der
Ente	die
Blockade	die
Gerechtigkeit	die
Zeichnung	die
Engel	der
Topf	der
Umsetzung	die
Pokal	der
Resolution	die
Rente	die
Behauptung	die
Disziplin	die
Wolke	die
Freundschaft	die
Distanz	die
Abkommen	das
Absage	die
Urlaub	der
Aufschwung	der
Schwein	das
Gestalt	die
Kulisse	die
Golf	das
Hals	der
Koch	der
Delikt	das
Raucher	der
Jazz	der
Boom	der
Sucht	die
Unruhe	die
Rennen	das
Trick	der
Video	das
Senkung	die
Hessen	das
Pakt	der
Schlacht	die
Erziehung	die
Malerei	die
Pfund	das
Reiter	der
Substanz	die
Hahn	der
Dividende	die
Dilemma	das
Verlierer	der
Geste	die
Sekunde	die
Mitgliedschaft	die
Gewinner	der
Anruf	der
Illusion	die
Intendant	der
Fond	der
Kleid	das
Fusion	die
Haufen	der
Lesung	die
Erkrankung	die
Komplex	der
Vorgabe	die
Aufmerksamkeit	die
Resultat	das
Pilot	der
Christ	der
Attentat	das
Vergabe	die
Transport	der
Zigarette	die
Milch	die
Rhythmus	der
Erlaubnis	die
Anforderung	die
Graph	der
Log	das
Ampel	die
Formel	die
Erneuerung	die
Infrastruktur	die
Kroate	der
Direktion	die
Pol	der
Spektakel	der
Krebs	der
Ausweis	der
Ufer	das
Mode	die
Semester	das
Betrug	der
Unternehmer	der
Satzung	die
Bord	das
Werkstatt	die
Busch	der
Eile	die
Drama	das
Instanz	die
Party	die
Passant	der
Streife	die
Garage	die
Kapitel	das
Kiste	die
Genossenschaft	die
Kubikmeter	der
Horn	das
Brunnen	der
Kandidatur	die
Vielfalt	die
Diplomat	der
Ofen	der
Entsorgung	die
Panzer	der
Reduzierung	die
Vermittlung	die
Armut	die
Herstellung	die
Frucht	die
Hindernis	das
Schlange	die
Begeisterung	die
Empfang	der
Jacke	die
Insasse	der
Medizin	die
Italiener	der
Schreiber	der
Terror	der
Etage	die
Ausweg	der
Aufsicht	die
Zusage	die
Konstruktion	die
Schmerz	der
Anstrengung	die
Spezialist	der
Moslem	der
Leib	der
Braun	das
Mafia	die
Orientierung	die
Eigentum	das
Autobahn	die
Revision	die
Pflanze	die
Knast	der
Moskauer	der
Ei	das
Interpretation	die
Schnee	der
Ehrung	die
Aufstand	der
Boykott	der
Zentimeter	das
Unsicherheit	die
Partnerschaft	die
Zahn	der
Geschmack	der
Rebell	der
Beschreibung	die
Passagier	der
Revier	das
Korb	der
Mythos	der
Gruppierung	die
Kasten	der
Rezession	die
Konsum	der
Loge	die
Bedrohung	die
Embargo	das
Zaun	der
Alarm	der
Kohle	die
Diktatur	die
Kaffee	der
Trio	das
Fahndung	die
Beobachtung	die
Pariser	der
Maske	die
Intervention	die
Prinz	der
Referat	das
Ausfall	der
Botschafter	der
Jury	der
Becken	das
Papst	der
Kategorie	die
Anzug	der
Kuh	die
Anweisung	die
Kalender	der
Nein	das
Lob	der
Import	der
Vorurteil	das
Erbe	der
Brite	der
Franke	der
Formulierung	die
Automat	der
Stillstand	der
Glaube	der
Gewehr	das
Gebot	das
Entlastung	die
Erhalt	der
Religion	die
Inhaber	der
Zensur	die
Vergewaltigung	die
Verpackung	die
Skinhead	der
Passage	die
Dialog	der
Zitat	das
Historiker	der
Impuls	der
Sex	der
Umfeld	das
Hunger	der
Fuchs	der
Gefecht	das
Resonanz	die
Fernsehen	das
Schmuck	der
Anzahl	die
Reporter	der
Wanderer	der
Damm	der
Option	die
Logik	die
Verbrennung	die
Mitteilung	die
Sorte	die
Offensive	die
Kugel	die
Bewerbung	die
Bewertung	die
Bayer	der
Organisator	der
Grube	die
Gegenstand	der
Sachsen	das
Favorit	der
Toilette	die
Gesang	der
Vorsitz	der
Auszeichnung	die
Zuschlag	der
Applaus	der
Autonomie	die
Rechner	der
Weisung	die
Klarheit	die
Palette	die
Herkunft	die
Ausbruch	der
Asien	das
Flut	die
Profil	das
Vorsteher	der
Kreuzung	die
Unterbringung	die
Abfahrt	die
Nichts	das
Geduld	die
Bekenntnis	das
Geisel	die
Stift	das
Taktik	die
Panik	die
Beruhigung	die
Utopie	die
Konvention	die
Sand	der
Qualifikation	die
Duo	das
Massaker	das
Riese	der
Apotheke	die
Bock	der
Fassade	die
Irland	das
Neonazi	der
Faust	die
Rentner	der
Fee	die
Kaiser	der
Unterhaltung	die
Schiene	die
Durchbruch	der
Redner	der
Einstieg	der
Bindung	die
Humor	der
Libanon	der
Katze	die
Dietrich	der
Dokumentation	die
Graben	der
Ehre	die
Verschuldung	die
Bauch	der
Senior	der
Klischee	das
Anzeichen	das
Filiale	die
Tatsache	die
Besetzer	der
Wiener	der
Major	der
Krone	die
Verdienst	das
Aussiedler	der
Ernte	die
Vorgehen	das
Stamm	der
Anregung	die
Spektrum	das
Hammer	der
Propaganda	die
Geschlecht	das
Dank	der
Entdeckung	die
Verwendung	die
Hitze	die
Labor	das
Route	die
Akteur	der
Werft	die
Inflation	die
Verhinderung	die
Allee	die
Fotografie	die
Komponist	der
Messung	die
Problematik	die
Zusammenbruch	der
Installation	die
Halter	der
Kiel	der
Stange	die
Treppe	die
Vormittag	der
Vorrang	der
Skepsis	die
Leidenschaft	die
Vernunft	die
Chemie	die
Brett	das
Techniker	der
Seelsorge	die
Modernisierung	die
Absprache	die
Wurst	die
Argumentation	die
Abwehr	die
Trost	der
Mitternacht	die
Terrorist	der
Erleichterung	die
Verarbeitung	die
Begrenzung	die
Befreiung	die
Wurf	der
Gewerkschafter	der
Flamme	die
Zweig	der
Lizenz	die
Nationalismus	der
Abschaffung	die
Zulassung	die
Aussteller	der
Vorbehalt	der
Werfer	der
Schreck	der
Anordnung	die
Urkunde	die
Holm	der
Paradies	das
Ziffer	die
Schatz	der
Berechtigung	die
Aufstieg	der
Hall	der
Konfrontation	die
Korrektur	die
Unrecht	das
Kaste	die
Zunahme	die
Rettung	die
Verhaftung	die
Bezeichnung	die
Unmut	der
Kommissar	der
Siedler	der
Strand	der
Teppich	der
Aufregung	die
Weber	der
Apfel	der
Faschismus	der
Lampe	die
Reichtum	der
Fund	der
Bitte	die
Vortag	der
Takt	der
Rhein	der
Akzent	der
Diskriminierung	die
Monopol	das
Liebling	der
Freilassung	die
Bemerkung	die
Umstellung	die
Berechnung	die
Vernehmung	die
Priester	der
Komposition	die
Nachwuchs	der
Panne	die
Quartal	das
Villa	die
Wohl	das
Vorsicht	die
Lippe	die
Pech	das
Flur	der
Flagge	die
Kontinent	der
Regal	das
Korrespondent	die
Hang	der
Plastik	die
Aufforderung	die
Vorsprung	der
Abenteuer	das
Sympathie	die
Abhilfe	die
Heroin	das
Entscheid	der
Wunde	die
Eigenschaft	die
Verfall	der
Aufbruch	der
Sowjet	der
Schub	der
Verbund	der
Elend	das
Rubrik	die
Dirk	die
Verurteilung	die
Premier	der
Talent	das
Euphorie	die
Einwand	der
Klausel	die
Reis	der
Kapitalismus	der
Vergiftung	die
Liebhaber	der
Nachteil	der
Nebel	der
Sammler	der
Putsch	der
Deckung	die
Achtung	die
Behinderung	die
Extremist	der
Vermieter	der
Sehnsucht	die
Beseitigung	die
Rubel	der
Verschiebung	die
Moderator	der
Anbau	der
Ausstieg	der
Londoner	der
Zivilist	der
Anwender	der
Fertigung	die
Taxi	das
Anpassung	die
Aufhebung	die
Annahme	die
Mechanismus	der
Pfleger	der
Workshop	der
Dreck	der
Befragung	die
Verbrecher	der
Quartett	das
Kopie	die
Maus	die
Schlaf	der
Islam	der
Rache	die
Respekt	der
Transparent	das
Philosophie	die
Segen	der
Lein	der
Glocke	die
Enkel	der
Geruch	der
Afrikaner	der
Vermutung	die
Mine	die
Besatzung	die
Kranz	der
Schatten	der
Bude	die
Brust	die
Garde	die
Scheidung	die
Attraktion	die
Basar	der
Brille	die
Horizont	der
Tennis	das
Stall	der
Verwirrung	die
Pilz	der
Format	das
Agent	der
Brecher	der
Zirkus	der
Austritt	der
Reinigung	die
Betreuer	der
Krach	der
Reiz	der
Arier	der
Gegenwart	die
Winkel	der
Bibel	die
Absturz	der
Darsteller	der
Exil	das
Rausch	der
Weile	die
Athlet	der
Staub	der
Hemd	das
Melodie	die
Spaltung	die
Spender	der
Wall	der
Koffer	der
Verweigerung	die
Spritze	die
Gleis	das
Mitarbeit	die
Kurdistan	das
Ritual	das
Kader	der
Mantel	der
Sparte	die
Recherche	die
Tee	das
Anliegen	das
Stellvertreter	der
Beutel	der
Benzin	das
Schaf	das
Rektor	der
Rinne	die
Sessel	der
Munition	die
Komponente	die
Schrei	der
Konkurs	der
Krimi	der
Durchsuchung	die
Norm	die
Ermittler	der
Kommandant	der
Teig	der
Gymnastik	die
Hobby	das
Heide	der
Kundschaft	die
Bremse	die
Tabu	das
Streich	der
Nahrung	die
Vernichtung	die
Kurve	die
Podium	das
Fonds	der
Radler	der
Weite	die
Heizung	die
Kerze	die
Zorn	der
Register	der
Bunker	der
Fink	der
Renovierung	die
Aktivist	der
Ruine	die
Aggression	die
Erfindung	die
Verschmutzung	die
Stolz	der
Indianer	der
Skulptur	die
Ahnung	die
Fleck	der
Renner	der
Franken	das
Ausschreitung	die
Toleranz	die
Furcht	die
Schwelle	die
Folter	die
Dichter	der
Ausweitung	die
Buchstabe	der
Aufarbeitung	die
Dose	die
Gemeinsamkeit	die
Kur	die
Chip	der
Harmonie	die
Nisse	die
Abfuhr	die
Konstellation	die
Schulter	die
Granate	die
Gitarre	die
Flieger	der
Irrtum	der
Australien	das
Laut	der
Albaner	der
Weisheit	die
Definition	die
Visum	das
Ironie	die
Saft	der
Inspektion	die
Mond	der
Bebauung	die
Entschuldigung	die
Besserung	die
Wahrnehmung	die
Laune	die
Territorium	das
Trauer	die
Vermittler	der
Kommunismus	der
Duell	das
Besichtigung	die
Frequenz	die
Suppe	die
Ausschreibung	die
Nachweis	der
Dynamik	die
Menschheit	die
Etappe	die
Zeugnis	das
Gebet	das
Wolle	die
Kindheit	die
Notwendigkeit	die
Fazit	das
Vietnamese	der
Fieber	das
Gewissen	das
Chinese	der
Schalter	der
Draht	der
Ansprache	die
Pension	die
Offenheit	die
Pflaster	das
Vorhang	der
Aufstellung	die
Herzog	der
Tabelle	die
Umstrukturierung	die
Infektion	die
Atem	der
Baden	das
Erhaltung	die
Kolonie	die
Lektion	die
Stadium	das
Kabel	das
Eintracht	die
Kamerad	der
Pille	die
Gitter	das
Einbrecher	der
Versprechen	das
Nische	die
Ferne	die
Schwabe	der
Acker	der
Entfernung	die
Moschee	die
Ankunft	die
Scheck	der
Milieu	das
Reparatur	die
Betrachter	der
Legende	die
Gras	das
Andrang	der
Stifter	der
Beleidigung	die
Klavier	das
Springer	der
Kenner	der
Auszug	der
Gesetzgebung	die
Notiz	die
Tournee	die
Wiederholung	die
Gesellschafter	der
Kombination	die
Hospital	der
Brauerei	die
Vertrieb	der
Dezernat	das
Betreiber	der
Anreiz	der
Buche	die
Schadstoff	der
Raub	der
Begleiter	der
Echo	das
Zwecke	die
Kassette	die
Parlamentarier	der
Verleihung	die
Rechen	der
Glanz	der
Fang	der
Diebstahl	der
Elite	die
Motivation	die
Verwalter	der
Verursacher	der
Begleitung	die
Dampf	der
Erwerb	der
Demokratisierung	die
Freizeit	die
Indiz	das
Eimer	der
Esse	die
Hase	der
Knochen	der
Abrechnung	die
Verrat	der
Anlauf	der
Initiator	der
Entwarnung	die
Verzweiflung	die
Schwung	der
Repertoire	das
Bezahlung	die
Formation	die
Spanier	der
Original	das
Verwertung	die
Reportage	die
Zoll	das
Depot	das
Verweigerer	der
Kondom	das
Anhebung	die
Wendung	die
Kloster	das
Antisemitismus	der
Bearbeitung	die
Katholik	der
Unsinn	der
Araber	der
Neuerung	die
Anfall	der
Karton	der
Klassiker	der
Faschist	der
Nikolaus	der
Erhebung	die
Foyer	das
Design	das
Vulkan	der
Friedhof	der
Aufgebot	der
Software	die
Puppe	die
Ultimatum	das
Schlamm	der
Fundamentalist	der
Herd	der
Salz	das
Album	das
Sensation	die
Makler	der
Hollywood	das
Angreifer	der
Auslieferung	die
Ressource	die
Faden	der
Onkel	der
Lehrling	der
Bestellung	die
Nadel	die
Yen	der
Psychologe	der
Verlegung	die
List	die
Weihnachten	das
Huhn	das
Lagerung	die
Kumpel	der
Junkie	der
Miliz	die
Ballon	der
Waggon	der
Einzug	der
Beleg	der
Obst	das
Killer	der
Abtreibung	die
Vorrat	der
Zusammensetzung	die
Terrain	das
Sterben	das
Einkommen	das
Hit	der
Hort	der
Triumph	der
Belohnung	die
Ratte	die
Kondition	die
Manipulation	die
Arabien	das
Neuling	der
Streifen	der
Coup	der
Gewohnheit	die
Holland	das
Umgehung	die
Orgel	die
Stille	die
Ideal	das
Ritter	der
Kabarett	das
Trasse	die
Tiefe	die
Abnehmer	der
Symptom	das
Vermeidung	die
Pfad	der
Axel	der
Guerilla	der
Patriot	der
Tank	der
Maurer	der
Silber	das
Philosoph	der
Mast	der
Hinrichtung	die
Reformer	der
Korn	das
Eskalation	die
Umschlag	der
Knie	das
Kartoffel	die
Box	die
Auswertung	die
Klientel	das
Ausweisung	die
Betrachtung	die
Resignation	die
Bart	der
Stempel	der
Strahlung	die
Orden	der
Diagnose	die
Amnestie	die
Besonderheit	die
Idylle	die
Kessel	der
Inland	das
Laster	das
Sekte	die
Tief	das
Prominenz	die
Umwandlung	die
Verabschiedung	die
Beton	der
Reibung	die
Aufschrift	die
Gleichheit	die
Zucker	der
Flaute	die
Erholung	die
Abgang	der
Durchgang	der
Dom	der
Ballett	das
Anleihe	die
Hymne	die
Vorverkauf	der
Langeweile	die
Tugend	die
Futter	das
Vorliebe	die
Speicher	der
Wurm	der
Mitleid	das
Geschick	das
Sperrung	die
Anblick	der
Anlieger	der
Fundament	das
Journalismus	der
Verbrechen	das
Erpressung	die
Trupp	der
Schwangerschaft	die
Entspannung	die
Salat	der
Dioxin	das
Sachverhalt	der
Dunkelheit	die
Honorar	das
Abitur	das
Immobilie	die
Isolation	die
Genre	das
Vorsorge	die
Merkmal	das
Planet	der
Tracht	die
Unschuld	die
Hirsch	der
Ruhm	der
Disposition	die
Entzug	der
Zeugung	die
Depression	die
Cocktail	das
Neigung	die
Schuster	der
Banane	die
Feder	die
Bub	der
Lawine	die
Grieche	der
Zwerg	der
Plenum	das
Ausschnitt	der
Lesbe	die
Gunst	die
Satire	die
Verdrossenheit	die
Wahn	der
Predigt	die
Benutzer	der
Abwesenheit	die
Nationalist	der
Klappe	die
Becher	der
Beschaffung	die
Anbindung	die
Chemikalie	die
Papa	der
Elbe	die
Emission	die
Aufzeichnung	die
Tempel	der
Kontingent	das
Krupp	der
Schnur	die
Satellit	der
Beurteilung	die
Formular	das
Zuwendung	die
Schacht	der
Sarg	der
Magen	der
Kerl	der
Festlegung	die
Schulung	die
Theke	die
Metropole	die
Nest	das
Plutonium	das
Anrufer	der
Packung	die
Razzia	die
Tombola	die
Belebung	die
Latte	die
Leine	die
Niederlassung	die
Bagger	der
Schilling	der
Hierarchie	die
Tausch	der
Lupe	die
Wurzel	die
Schutt	der
Auftrieb	der
Verpflegung	die
Terrorismus	der
Zucht	die
Vorzug	der
Voranmeldung	die
Epoche	die
Seher	der
Kolonne	die
Ortschaft	die
Schar	die
Kabine	die
Rasse	die
Kraut	das
Beleuchtung	die
Lette	der
Barriere	die
Intelligenz	die
Schlager	der
Verbreitung	die
Metapher	die
Pastor	der
Hain	der
Klo	das
Gliederung	die
Zeremonie	die
Schema	das
Darbietung	die
Provokation	die
Verweis	der
Laie	der
Folie	die
Tschechoslowakei	die
Hoch	das
Unklarheit	die
Verstand	der
Verlagerung	die
Kontrahent	der
Dosis	die
Pleite	die
Zulieferer	der
Weide	die
Manier	die
Verunsicherung	die
Strang	der
Gutachten	das
Trip	der
Gouverneur	der
Parade	die
Ansiedlung	die
Hauch	der
Anschaffung	die
Invasion	die
Barrikade	die
Landung	die
Jubel	der
Abstieg	der
Verwirklichung	die
Dirigent	der
Camp	das
Kontext	der
Konzession	die
Enthaltung	die
Vermarktung	die
Vers	der
Don	der
Clown	der
Balkon	der
Oma	die
Ration	die
Aufteilung	die
Zugabe	die
Minimum	das
Radikal	das
Errichtung	die
Leid	das
Krawall	der
Ambition	die
Tante	die
Musical	das
Zeichner	der
Riege	die
Folgerung	die
Quittung	die
Domizil	das
Anleitung	die
Visier	das
Schaltung	die
Audi	der
Unzufriedenheit	die
Unruh	die
Gesuch	das
Episode	die
Luxus	der
Inspektor	der
Diskurs	der
Glied	das
Reife	die
Ordner	der
Deckel	der
Kippe	die
Wirbel	der
Ausstrahlung	die
Ambiente	das
Gebirge	das
Pfiff	der
Abwicklung	die
Slowakei	die
Anwesenheit	die
Herausgeber	der
Bulle	die
Schwanz	der
Schere	die
Befund	der
Umbruch	der
Gerede	das
Ast	der
Salon	der
Fett	das
Befugnis	die
Fete	die
Absicherung	die
Ansturm	der
Uniform	die
Jubilar	der
Gewitter	das
Kontrast	der
Comic	der
Fell	das
Nerv	der
Tasse	die
Vertreibung	die
Halde	die
Verzeichnis	das
Gehirn	das
Gespenst	das
Fliege	die
Witwe	die
Tiger	der
Schrott	der
Riegel	der
Arena	die
Anwesen	das
Strahl	der
Pult	das
Reklame	die
Baracke	die
Brenner	der
Vieh	das
Geschirr	das
Kellner	der
Balkan	der
Derby	das
Schlauch	der
Parkett	das
Kiosk	der
Publikation	die
Radikalismus	der
Hagel	der
Routine	die
Marathon	der
Ozon	das
Revue	die
Hauer	der
Kommentator	der
Elefant	der
Adler	der
Bronze	die
Kalkulation	die
Linde	die
Lache	die
Sekt	der
Versagen	der
Ski	der
Expansion	die
Abwasser	das
Psychologie	die
Leiden	das
Doktor	der
Beachtung	die
Abdruck	der
Fotograf	der
Kult	der
Solo	das
Dia	das
Zerfall	der
Warte	die
Pfeil	der
Esel	der
Kokain	das
Prozessor	der
Skala	die
Achse	die
Gelassenheit	die
Portion	die
Sonnabend	der
Umgestaltung	die
Durchsetzung	die
Entsendung	die
Beerdigung	die
Qual	die
Struwwelpeter	der
Zulage	die
Marketing	das
Tenor	der
Avantgarde	die
Besprechung	die
Kosovo	das
Steg	der
Nachholbedarf	der
Eiche	die
Antritt	der
Bedienung	die
Miene	die
Aussprache	die
Ausbeutung	die
Stirn	die
Blitz	der
Synagoge	die
Leere	die
Poesie	die
Staffel	die
Konsortium	das
Festung	die
Kleinigkeit	die
Kran	der
Wrack	das
Belag	der
Auslastung	die
Debakel	das
Trumpf	der
Diener	der
Entnahme	die
Veto	das
Leder	das
Konsulat	das
Henkel	der
Komplize	der
Lenker	der
Tropfen	der
Randalierer	der
Abgrund	der
Individuum	das
Zutritt	der
Transporter	der
Narr	der
Waage	die
Haken	der
Siegel	das
Dusche	die
Aufschlag	der
Dschungel	der
Assoziation	die
Blech	das
Zufriedenheit	die
Trotz	der
Realismus	der
Rosa	das
Indonesien	das
Nutzen	der
Pavillon	der
Dissident	der
Laus	die
Beendigung	die
Designer	der
Typus	der
Kurier	der
Kai	der
Dozent	der
Infarkt	der
Schleife	die
Kontrolleur	der
Ausschlag	der
Renaissance	die
Bote	der
Feststellung	die
Kartell	das
Diktator	der
Funke	der
Statut	der
Solist	der
Pionier	der
Umweg	der
Verschlechterung	die
Tanker	der
Krug	der
Kartei	die
Eifer	der
Sitte	die
Vermerk	der
Wild	das
Aufkleber	der
Zyklus	der
Streitigkeit	die
Essay	das
Rampe	die
Nutzer	der
Fiktion	die
Birne	die
Abzeichen	das
Bestrebung	die
Einsamkeit	die
Piste	die
Liberalisierung	die
Kollision	die
Chronik	die
Batterie	die
Promille	die
Armenier	der
Bescheinigung	die
Report	der
Collage	die
Pendler	der
Lenz	der
Urne	die
Tscheche	der
Bescheidenheit	die
Aufwendung	die
Rasen	das
Gen	das
Machthaber	der
Ethik	die
Zivilisation	die
Quatsch	der
Segment	das
Ader	die
Schelte	die
Abstrich	der
Kontur	die
Absolvent	der
Rivale	die
Rind	das
Iraker	der
Wette	die
Schmuggel	der
Gag	der
Bube	der
Bob	der
Spekulant	der
Abwechslung	die
Lyrik	die
Klotz	der
Fracht	die
Konsument	der
Erzeugnis	das
Kollaps	der
Ausreise	die
Errungenschaft	die
Katalysator	der
Insekt	das
Parallele	die
Ruck	der
Hai	der
Haschisch	das
Stiefel	der
Affe	der
Deck	das
Eichel	die
Duft	der
Pop	der
Druckerei	die
Lore	die
Kaninchen	das
Schande	die
Jordan	der
Manuskript	das
Scheune	die
Diplomatie	die
Gier	die
Bonus	der
Detektiv	der
Scherz	der
Trakt	der
Uran	das
Feierlichkeit	die
Bosnier	der
Spion	der
Drucker	der
Obduktion	die
Kommandeur	der
Asche	die
Hinblick	der
Trieb	der
Filter	der
Menschlichkeit	die
Gau	der
Aufstockung	die
Teich	der
Treue	die
Trommel	die
Meile	die
Krieger	der
Spitzel	der
Vormarsch	der
Pfeiler	der
Teiler	der
Riff	der
Urlauber	der
Ausgrenzung	die
Aufzug	der
Karussell	das
Pest	die
Abfindung	die
Aal	der
Saarland	das
Altar	der
Lee	die
Setzer	der
Monster	das
Ausverkauf	der
Faszination	die
Gerangel	das
Reden	das
Schauer	der
Tomate	die
Verschiedenheit	die
Meteorologe	der
Entstehung	die
Schilderung	die
Vitrine	die
Hehl	der
Unterhalt	der
Courage	die
Kleidung	die
Erzeugung	die
Rummel	der
Seuche	die
Betroffenheit	die
Arsch	der
Lexikon	das
Novelle	die
Breite	die
Stipendium	das
Veteran	der
Frosch	der
Koordination	die
Arsenal	das
Sortiment	das
Zusammenkunft	die
Unterzeichnung	die
Transparenz	die
Island	das
Bursche	der
Schwund	der
Lese	die
Provisorium	das
Vakuum	das
Verringerung	die
Ausrichtung	die
Begehren	das
Epidemie	die
Sau	die
Rhetorik	die
Gnade	die
Eid	der
Erscheinen	das
Antenne	die
Blase	die
Geiger	der
Ziehung	die
Augenmerk	der
Unentschieden	das
Maul	das
Nachbarschaft	die
Dementi	das
Frachter	der
Prozedur	die
Vorsatz	der
Putz	der
Methadon	das
Erreger	der
Jugoslawe	der
Gemisch	das
Soziologe	der
Mist	der
Arroganz	die
Brigade	die
Eisen	das
Romantik	die
Assistent	der
Bestrafung	die
Versicherer	der
Wolfram	das
Abgrenzung	die
Hilflosigkeit	die
Dekan	der
Knopf	der
Umkreis	der
Farm	die
Vogt	der
Einfuhr	die
Seil	das
Seltenheit	die
Wahrscheinlichkeit	die
Aufprall	der
Szenarium	das
Gebilde	das
Flotte	die
Impfung	die
Zulauf	der
Organismus	der
Dichte	die
Neid	der
Verschwendung	die
Zynismus	der
Variation	die
Psychiatrie	die
Ostern	das
Beschleunigung	die
Freundlichkeit	die
Hektik	die
Singen	das
Schraube	die
Raser	der
Wal	der
Beliebtheit	die
Fax	das
Herrscher	der
Abschlag	der
Terrasse	die
Schwankung	die
Knecht	der
Weihe	die
Pathos	das
Meiler	der
Schenkel	der
Jargon	der
Clique	die
Pater	der
Ovation	die
Schoppen	der
Subjekt	das
Alkoholiker	der
Abseits	das
Ungerechtigkeit	die
Korps	das
Gestern	das
Lehrgang	der
Karikatur	die
Ansehen	das
Improvisation	die
Abgas	das
Prototyp	der
Kollektiv	das
Pumpe	die
Schwindel	der
Dramaturgie	die
Zuschrift	die
Zugriff	der
Physiker	der
Ohnmacht	die
Knappheit	die
Nachdruck	der
Tresor	der
Pfosten	der
Geschrei	das
Lieferant	der
Gewahrsam	der
Deserteur	der
Zimmermann	der
Kitsch	der
Fels	der
Traube	die
Frost	der
Pose	die
Gehweg	der
Erfinder	der
Spanne	die
Heirat	die
Perle	die
Differenzierung	die
Etikett	das
Kanone	die
Ire	der
Cola	die
Blau	das
Aufsatz	der
Besorgnis	die
Sumpf	der
Eroberung	die
Kriminalpolizei	die
Auslegung	die
Reservat	das
Steiger	der
Kante	die
Sekretariat	das
Gangster	der
Artillerie	die
Verseuchung	die
Zusatz	der
Weib	das
Dummheit	die
Splitter	der
Denker	der
Monitor	der
Allergie	die
Vorlesung	die
Gattung	die
Nominierung	die
Szenerie	die
Tango	der
Antrieb	der
Nordsee	die
Dekret	das
Zuflucht	die
Leutnant	der
Ermordung	die
Beitritt	der
Prinzessin	die
Prophet	der
Zauber	der
Korridor	der
Set	das
Hieb	der
Smog	der
Besteuerung	die
Andacht	die
Statistiker	der
Schmied	der
Umschwung	der
Iraner	der
Vorgeschichte	die
Evakuierung	die
Arrest	der
Hysterie	die
Angleichung	die
Ausfuhr	die
Defekt	der
Emanzipation	die
Bodensee	der
Filz	der
Syndrom	das
Pianist	der
Grausamkeit	die
Kosmetik	die
Schnauze	die
Habe	die
Muskel	der
Ignoranz	die
Zentner	der
Kantine	die
Entfremdung	die
Vorfahrt	die
Naht	die
Pfeife	die
Lack	der
Spirale	die
Vorort	der
Legitimation	die
Stapel	der
Taler	der
Lamm	das
Zunft	die
Schlepper	der
Wiedergutmachung	die
Taube	die
Gewand	das
Inbetriebnahme	die
Manko	das
Nenner	der
Umschulung	die
Scham	die
Steuerung	die
Stockwerk	das
Kluft	die
Schimmer	der
Schachtel	die
Vermietung	die
Chemiker	der
Finder	der
Sohle	die
Libero	der
Praktikum	das
Mitstreiter	der
Kissen	das
Kubaner	der
Hauptversammlung	die
Laterne	die
Donau	die
Verbindlichkeit	die
Durcheinander	das
Panorama	das
Modus	der
Knall	der
Hebel	der
Verfasser	der
Aufschrei	der
Ersparnis	die
Keim	der
Brechung	die
Konserve	die
Hoheit	die
Ventil	das
Pate	der
Retter	der
Sympathisant	der
Materie	die
Erzieher	der
Skizze	die
Verfolger	der
Butter	die
Sockel	der
Skelett	das
Losung	die
Kontroverse	die
Grafik	die
Kehrer	der
Silvester	der
Hergang	der
Turbulenz	die
Zigeuner	der
Daumen	der
Vorzeichen	das
Terminal	das
Bearbeiter	der
Effizienz	die
Genugtuung	die
Sektion	die
Vernetzung	die
Mahnung	die
Aufschub	der
Demontage	die
Auftreten	das
Reflexion	die
Pappe	die
Niederlegung	die
Verachtung	die
Falke	der
Torwart	der
Kreml	der
Konsolidierung	die
Jahrgang	der
Eintragung	die
Verleih	der
Trauma	das
Roboter	der
Widrigkeit	die
Rationalisierung	die
Schnaps	der
Ursprung	der
Kram	der
Deportation	die
Trikot	das
Reigen	der
Opa	der
Fluktuation	die
Billion	die
Freak	der
Umlauf	der
Umbenennung	die
Legalisierung	die
Prellung	die
Plakette	die
Mohr	der
Gewinnung	die
Isolierung	die
Mithilfe	die
Krippe	die
Chirurg	der
Matratze	die
Prosa	die
Vorstadt	die
Gage	die
Wappen	das
Abweichung	die
Patrouille	die
Sage	die
Schnitte	die
Vorabend	der
Wucht	die
Dichtung	die
Kummer	der
Christus	der
Faser	die
Heck	das
Heuchelei	die
Schlappe	die
Mikrofon	das
Feminismus	der
Polster	das
Umkehr	die
Zusammenspiel	das
Getreide	das
Bon	der
Ernennung	die
Hockey	das
Gespann	das
Asbest	der
Mitbestimmung	die
Endung	die
Amateur	der
Sofa	das
Berichtigung	die
Folklore	die
Anekdote	die
Seligkeit	die
Ehrlichkeit	die
Verdiener	der
Asphalt	der
Aufwind	der
Monarchie	die
Ruin	der
Schottland	das
Diktat	das
Untreue	die
Bucht	die
Kapitulation	die
Ausbeute	die
Hooligan	der
Dolmetscher	der
Mehl	das
Brei	der
Gefangenschaft	die
Gastronomie	die
Gefallen	der
Erzeuger	der
Leber	die
Braut	die
Ausbilder	der
Inder	der
Spott	der
Christentum	das
Enteignung	die
Melancholie	die
Nacken	der
Quotierung	die
Gestank	der
Sparer	der
Olympiade	die
Oberst	der
Aquarell	das
Umverteilung	die
Kanalisation	die
Krawatte	die
Dekoration	die
Vorrunde	die
Airbus	der
Schranke	die
Anspielung	die
Symposium	das
Kiefer	die
Indikation	die
Stabilisierung	die
Belegung	die
Pogrom	das
Haftung	die
Schokolade	die
Koreaner	der
Ausblick	der
Beschimpfung	die
Praktiker	der
Tirol	das
Gewebe	das
Vorarbeit	die
Vernissage	die
Code	der
Testament	das
Seidel	der
Taufe	die
Pentagon	das
Befriedigung	die
Gitarrist	der
Stagnation	die
Versuchung	die
Aufmarsch	der
Beschuldigung	die
Privileg	das
Hebamme	die
Spielerei	die
Kompliment	das
Datei	die
Lokomotive	die
Gans	die
Ewigkeit	die
Emigrant	der
Bomber	der
Physik	die
Reederei	die
Lateinamerika	das
Wirksamkeit	die
Sattel	der
Journal	das
Pointe	die
Abbildung	die
Montage	die
Dasein	das
Vollmacht	die
Entsetzen	das
Marine	die
Aufwertung	die
Neuigkeit	die
Schale	die
Nostalgie	die
Kalb	das
Versorger	der
Bankier	der
Symbolik	die
Grammatik	die
Genie	das
Mitwirkung	die
Wiege	die
Boxer	der
Biene	die
Anschein	der
Erotik	die
Gemeinheit	die
Schleuder	die
Schach	das
Projektion	die
Vorhersage	die
Kreide	die
Abstammung	die
Geiselnahme	die
Verleumdung	die
Bakterie	die
Verwandtschaft	die
Gummi	der
Aufruhr	der
Heil	das
Unterbrechung	die
Therapeut	der
Untergang	der
Verfechter	der
Exkursion	die
Ami	der
Anarchie	die
Spatz	der
Oscar	der
Gatte	der
Zeche	die
Socke	die
Theologie	die
Kupfer	das
Pegel	der
Groschen	der
Dorn	der
Wirtschaftlichkeit	die
Pool	der
Simulation	die
Diesel	der
Polemik	die
Schikane	die
Beere	die
Division	die
Vorwort	das
Maschinerie	die
Dreieck	das
Meditation	die
Schleier	der
Robe	die
Bataillon	das
Innung	die
Identifikation	die
Same	der
Mobilisierung	die
Oase	die
Pelz	der
Eitelkeit	die
Metier	das
Fundamentalismus	der
Kuratorium	das
Wecker	der
Umleitung	die
Kuppel	die
Kollegium	das
Soll	das
Pack	das
Mitspieler	der
Lobbyist	der
Lord	der
Emigration	die
Pestizid	das
Abnahme	die
Parzelle	die
Schwimmer	der
Limousine	die
Dynamo	der
Abtransport	das
Mechaniker	der
Fasching	der
Atlantik	der
Vorplatz	der
Besinnung	die
Barometer	das
Zauberer	der
Unheil	das
Narbe	die
Pracht	die
Abchasien	das
Patriotismus	der
Dialekt	der
Relation	die
Anmerkung	die
Entschlossenheit	die
Stratege	der
Visite	die
Reservist	der
Schornstein	der
Brocken	der
Patenschaft	die
Neger	der
Vorwand	der
Dramatik	die
Kappe	die
Psychiater	der
Ausdehnung	die
Informant	der
Gesinnung	die
Schwert	das
Magnet	der
Vorentscheidung	die
Kaution	die
Zwilling	der
Omnibus	der
Gala	die
Eber	der
Revolver	der
Atlas	der
Theoretiker	der
Duldung	die
Neuheit	die
Idol	das
Zustrom	der
Abwertung	die
Belgier	der
Verbrauch	der
Laube	die
Abkehr	die
Fertigkeit	die
Sprichwort	das
Niere	die
Balance	die
Planke	die
Enklave	die
Schmutz	der
Hormon	das
Tibet	das
Nonne	die
Feuchtigkeit	die
Flair	das
Kreisel	der
Hexe	die
Durchfahrt	die
Lockerung	die
Ankauf	der
Matte	die
Artist	der
Poker	das
Androhung	die
Segler	der
Tun	das
Importeur	der
Umbildung	die
Kanton	der
Utensil	das
Schleuse	die
Masche	die
Haube	die
Ziege	die
Internet	das
Niedersachsen	das
Ruder	das
Mathematik	die
Scherbe	die
Lektor	der
Alibi	das
Idiot	der
Sirene	die
Restaurierung	die
Binder	der
Verantwortlichkeit	die
Antarktis	die
Tabak	der
Unwetter	das
Niedergang	der
Gestell	das
Einreise	die
Heiterkeit	die
Herberge	die
Glatze	die
Versteck	das
Klient	der
Prediger	der
Bestechung	die
Desinteresse	das
Pullover	der
Hygiene	die
Bistum	das
Grimm	der
Kaukasus	der
Umlage	die
Arie	die
Gros	das
Trinker	der
Brasilianer	der
Abschreibung	die
Rabe	der
Sklave	der
Rechtfertigung	die
Apotheker	der
Posse	die
Kerbe	die
Vormonat	der
Seelsorger	der
Superlativ	der
Transplantation	die
Flora	die
Fledermaus	die
Aula	die
Rechenschaft	die
Ungar	der
Thematik	die
Winzer	der
Fluch	der
Angel	die
Normalisierung	die
Auktion	die
Remis	das
Kabarettist	der
Vergessenheit	die
Diskothek	die
Ruhrgebiet	das
Inschrift	die
Kater	der
Gelenk	das
Rutsch	der
Penner	der
Geflecht	das
Optimist	der
Vorname	der
Bereinigung	die
Beet	das
Gehorsam	der
Putschist	der
Kap	das
Athletik	die
Abneigung	die
Skeptiker	der
Kahn	der
Baron	der
Pfand	der
Entwickler	der
Hetze	die
Karre	die
Kehle	die
Bohrung	die
Honig	der
Skandinavien	das
Manifest	das
Angler	der
Lorbeer	der
Reflex	der
Plage	die
Relikt	das
Torte	die
Ratifizierung	die
Quintett	das
Durst	der
Chauffeur	der
Choreographie	die
Komfort	der
Appetit	der
Reduktion	die
Instandsetzung	die
Gulden	der
Koran	der
Nachbesserung	die
Mahl	das
Genauigkeit	die
Doping	das
Beihilfe	die
Peinlichkeit	die
Parodie	die
Qualifizierung	die
Imperialismus	der
Intrige	die
Abschreckung	die
Musikant	das
Vierbeiner	der
Markierung	die
Festigkeit	die
Interpret	der
Lebewesen	das
Rohstoff	der
Traktor	der
Abreise	die
Ried	das
Reue	die
Gehen	das
Beisitzer	der
Ambulanz	die
Sog	der
Marge	die
Fiskus	der
Besen	der
Karosse	die
Kaliber	das
Kardinal	der
Trubel	der
Akademiker	der
Schotte	der
Dioxid	das
Regiment	das
Verkleidung	die
Weizen	der
Schmiede	die
Pessimismus	der
Widersacher	der
Phrase	die
Wirtin	die
Klemme	die
Versetzung	die
Stier	der
Vorgarten	der
Instrumentarium	das
Saite	die
Hohn	der
Pyramide	die
Tau	der
Optik	die
Geige	die
Seife	die
Dringlichkeit	die
Ritt	der
Schneise	die
Kompost	der
Notar	der
Vorgehensweise	die
Orgie	die
Heilung	die
Keramik	die
Expedition	die
Biologie	die
Norweger	der
Harz	der
Cholera	die
Enge	die
Auslosung	die
Bulgare	der
Voraussicht	die
Rabatt	der
Herausforderer	der
Mappe	die
Rallye	die
Portal	das
Beil	das
Telegramm	das
Aussetzung	die
Erpresser	der
Garant	der
Windung	die
Vorspiel	das
Geschlossenheit	die
Vignette	die
Leichtigkeit	die
Erfassung	die
Makulatur	die
Rezeption	die
Pfeffer	der
Befehlshaber	der
Residenz	die
Klausur	die
Herde	die
Vermehrung	die
Hinspiel	das
Reim	der
Rost	der
Vehikel	das
Kapitalist	der
Schwere	die
Anker	der
Grill	der
Schimmel	der
Horten	das
Unternehmung	die
Karambolage	die
Verzug	der
Diskette	die
Spionage	die
Gurke	die
Stiel	der
Slowake	der
Vorreiter	der
Leichnam	der
Sauna	die
Taucher	der
Beifahrer	der
Abt	der
Konsul	der
Dominanz	die
Poet	der
Schnelligkeit	die
Krabbe	die
Vorbedingung	die
Feuilleton	das
Fichte	die
Universum	das
Empfindung	die
Extrem	das
Vesper	die
Balken	der
Frisur	die
Moor	das
Nachspiel	das
Opus	der
Speise	die
Fundus	der
Verunreinigung	die
Generator	der
Auszahlung	die
Emblem	das
Begierde	die
Wahrung	die
Abordnung	die
Mais	der
Deich	der
Metro	die
Drache	der
Aue	die
Hiobsbotschaft	die
Junta	die
Globus	der
Verteuerung	die
Windel	die
Judentum	das
Kasper	der
Kanadier	der
Granat	der
Schlosser	der
Ausrede	die
Hure	die
Buchung	die
Unstimmigkeit	die
Matrose	der
Spezies	die
Aus	das
Ikone	die
Monolog	der
Migration	die
Strumpf	der
Pluralismus	der
Fanatiker	der
Tapete	die
Alt	das
Basketball	der
Testen	das
Gabel	die
Kanister	der
Veranlassung	die
Thriller	der
Knacker	der
Requisit	das
Inkrafttreten	das
Ehrgeiz	der
Sparsamkeit	die
Rehabilitierung	die
Soziologie	die
Schuldner	der
Professur	die
Trompete	die
Muschel	die
Tube	die
Unterredung	die
Watt	das
Teuerung	die
Neugier	die
Dramatiker	der
Ausbreitung	die
Jeep	der
Verflechtung	die
Barbarei	die
Liegenschaft	die
Punker	der
Bonbon	das
Labyrinth	das
Krampf	der
Getriebe	das
Aluminium	das
Verwechslung	die
Ausrutscher	der
Astronaut	der
Erregung	die
Jura	das
Stationierung	die
Junior	der
Sheriff	der
Hundertschaft	die
Aufsehen	das
Treiber	der
Pinsel	der
Geltung	die
Kanne	die
Mitbewerber	der
Prestige	das
Sauberkeit	die
Kocher	der
Schwaden	der
Mars	der
Thron	der
Evangelium	das
Patent	das
Instinkt	der
Bordell	das
Dialektik	die
Billigung	die
Psyche	die
Ansage	die
Flanke	die
Porzellan	das
Palme	die
Verbitterung	die
Segel	das
Pensionierung	die
Lena	die
Pflanzung	die
Leck	das
Trockenheit	die
Farmer	der
Schmuggler	der
Verdoppelung	die
Entfaltung	die
Frechheit	die
Hardware	die
Ergreifung	die
Abwanderung	die
Tiroler	der
Schlupf	der
Entgelt	das
Komplikation	die
Handwerker	der
Starter	der
Eisenbahner	der
Aufbereitung	die
Facette	die
Bekanntschaft	die
Feindschaft	die
Seilschaft	die
Spurt	der
Magie	die
Einleitung	die
Eindringling	der
Anhang	der
Mafioso	der
Wartung	die
Anschauung	die
Detonation	die
Logistik	die
Verzehr	der
Eule	die
Boutique	die
Sinfonie	die
Esser	der
Absender	der
Kassierer	der
Aussteiger	der
Donner	der
Denunziation	die
Sonate	die
Aufseher	der
Ableger	der
Ausklang	der
Pirat	der
Heber	der
Kittel	der
Moll	das
Schmetterling	der
Umschichtung	die
Gel	das
Weiche	die
Boulevard	der
Scientology	die
Advent	der
Champagner	der
Modul	das
Dampfer	der
Absperrung	die
Ukrainer	der
Session	die
Kamm	der
Kamin	der
Schal	der
Pauschale	die
Gehege	das
Tragik	die
Bewunderung	die
Bestattung	die
Dogma	das
Ungleichheit	die
Zutat	die
Idealismus	der
Marokkaner	der
Fastnacht	die
Schlesien	das
Lesen	das
Dekanat	das
Pfingsten	das
Tumor	der
Verlosung	die
Specht	der
Ozean	der
Folterung	die
Woge	die
Kaufmann	der
Floskel	die
Kolleg	das
Andeutung	die
Perfektion	die
Betonung	die
Mutti	die
Vereinfachung	die
Schmiererei	die
Tornado	der
Kosmos	der
Bergung	die
Partikel	das
Gestapo	die
Blei	das
Reservoir	das
Raupe	die
Schweinerei	die
Trage	die
Knoten	der
Raffinerie	die
Unordnung	die
Klinge	die
Bedauern	das
Atom	das
Kirsche	die
Gemarkung	die
Anzeiger	der
Urin	der
Registrierung	die
Abmachung	die
Pendant	das
Richtigkeit	die
Zusammenhalt	der
Sucher	der
Blutung	die
Algerier	der
Strick	der
Niederschlag	der
Rage	die
Unfug	der
Umsiedlung	die
Ansammlung	die
Storch	der
Grat	der
Hemmung	die
Fiasko	das
Kontrakt	der
Keule	die
Publizist	das
Gutachter	der
Tumult	der
Elan	der
Geselle	der
Abonnement	das
Qualm	der
Bewirtschaftung	die
Appartement	das
Auferstehung	die
Jammer	der
Reinheit	die
Rangelei	die
Exekution	die
Zusammenfassung	die
Binde	die
Weibchen	das
Pazifik	der
Opportunismus	der
Industrialisierung	die
Ideologe	der
Quadrat	das
Beat	der
Bestseller	der
Beanstandung	die
Pfahl	der
Quecksilber	das
Venus	die
Finsternis	die
Versand	der
Plane	die
Anflug	der
Verdichtung	die
Peripherie	die
Adel	der
Erfordernis	das
Anstrich	der
Strukturierung	die
Erforschung	die
Befindlichkeit	die
Sizilien	das
Phon	das
Abteil	das
Ausfahrt	die
Braten	der
Aushub	der
Bohne	die
Peitsche	die
Phantom	das
Unkenntnis	die
Ziegel	der
Koma	das
Attribut	das
Nennwert	der
Verzerrung	die
Doktrin	die
Koordinator	der
Erstellung	die
Beweggrund	der
Ablagerung	die
Gerade	die
Geiz	der
Zusammenprall	der
Automobil	das
Durchmesser	der
Lesart	die
Umrahmung	die
Wales	das
Libanese	der
Nuance	die
Intoleranz	die
Schaum	der
Wespe	die
Feige	die
Bandit	der
Vorlauf	der
Nomenklatur	die
Slum	der
Bestechlichkeit	die
Akkord	der
Pfanne	die
Synonym	das
Illustration	die
Verlangen	das
Hypothese	die
Spinner	der
Kragen	der
Orient	der
Lazarett	das
Begabung	die
Poliklinik	die
Ritus	der
Walzer	der
Silo	das
Informatik	die
Bergmann	der
Vergeltung	die
Keil	der
Hocker	der
Foul	das
Freier	der
Chirurgie	die
Verfilmung	die
Schelle	die
Wirkstoff	der
Porto	das
Rekrut	der
Gehilfe	der
Sibirien	das
Abstinenz	die
Kapsel	die
Inventar	das
Verlegenheit	die
Synthese	die
Ferse	die
Igel	der
Missionar	der
Konsultation	die
Karibik	die
Dezentralisierung	die
Ernsthaftigkeit	die
Kreuzer	der
Australier	der
Krokodil	das
Diva	die
Schwan	der
Montenegro	das
Kameradschaft	die
Portugiese	der
Absetzung	die
Reck	das
Sketch	der
Luxemburger	der
Elektronik	die
Glotze	die
Kantor	der
Sabotage	die
Geselligkeit	die
Spagat	der
Kutsche	die
Stroh	das
Spalt	der
Bruderschaft	die
Egoismus	der
Ausnutzung	die
Pilger	der
Abonnent	der
Abschaltung	die
Kadaver	der
Anstellung	die
Truhe	die
Ringer	der
Leuchte	die
Brauer	der
Lift	der
Revanche	die
Alkoholismus	der
Vokabular	das
Taumel	der
Finne	der
Schlucht	die
Galerist	der
Harmonisierung	die
Spalte	die
Verwicklung	die
Schwimmen	das
Latein	das
Sauerei	die
Seufzer	der
Bringer	der
Konter	der
Rotation	die
Fassbinder	der
Trab	der
Kompanie	die
Radierung	die
Kodex	der
Reif	der
Pazifismus	der
Zuschnitt	der
Regler	der
Boss	der
Delle	die
Tropf	der
Bewilligung	die
Segnung	die
Mitschuld	die
Wink	der
Exot	der
Quiz	das
Vertiefung	die
Besatzer	der
Eleganz	die
Pott	der
Chronist	der
Abschwung	der
Diplom	das
Halm	der
Reservierung	die
Adria	die
Beschneidung	die
Abmahnung	die
Ausschau	die
Politikum	das
Viech	das
Rudel	das
Spediteur	der
Axt	die
Identifizierung	die
Aquarium	das
Gratulant	der
Dossier	das
Erkundung	die
Bombardierung	die
Bewaffnung	die
Reh	das
Umtausch	der
Leger	der
Pacht	die
Belehrung	die
Oxid	das
Clinch	der
Wodka	der
Zar	der
Erosion	die
Ekel	der
Barren	der
Zerschlagung	die
Warner	der
Karawane	die
Makel	der
Litauer	der
Verankerung	die
Diamant	der
Ungeduld	die
Speck	der
Sauger	der
Mensa	die
Psychoanalyse	die
Eintrag	der
Unkraut	das
Diffamierung	die
Kompensation	die
Separatist	der
Podest	das
Handhabung	die
Wirrwarr	das
Ode	die
Zuzug	der
Massage	die
Hirt	der
Embryo	das
Lyriker	der
Akustik	die
Symbiose	die
Kommilitone	der
Argentinier	der
Deutlichkeit	die
Pazifist	der
Moderation	die
Klassik	die
Temperament	das
Lotus	der
Zwickel	der
Choreograph	der
Schaffner	der
Bettler	der
Fackel	die
Apokalypse	die
Zuneigung	die
Liberalismus	der
Strebe	die
Analogie	die
Schopf	der
Tilgung	die
Schrecken	der
Metamorphose	die
Dunst	der
Zusammenstellung	die
Darm	der
Keks	der
Guru	der
Bewachung	die
Nennung	die
Fixierung	die
Akrobatik	die
Alge	die
Politologe	der
Beschlagnahme	die
Reeder	der
Fort	das
Taste	die
Kolonialismus	der
Fresser	der
Werber	der
Monarch	der
Streiterei	die
Verbundenheit	die
Admiral	der
Neugierde	die
Schlitten	der
Gestein	das
Anarchist	der
Stumpf	der
Abbild	das
Vorruhestand	der
Ausarbeitung	die
Mitfahrer	der
Erle	die
Bescherung	die
Analytiker	der
Examen	das
Analphabet	der
Orange	das
Behausung	die
Bluse	die
Spedition	die
Eignung	die
Distanzierung	die
Geborgenheit	die
Funker	der
Akkordeon	das
Gewirr	das
Erteilung	die
Empfindlichkeit	die
Verwandlung	die
Versenkung	die
Verwarnung	die
Neffe	der
Drachen	der
Apostel	der
Anstand	der
Salve	die
Vergehen	das
Sorgfalt	die
Schwarm	der
Wagnis	das
Zertifikat	das
Abstraktion	die
Weigerung	die
Ambivalenz	die
Organist	der
Kathedrale	die
Gemetzel	das
Syrer	der
Zensor	der
Potenz	die
Teilchen	das
Beunruhigung	die
Fauna	die
Trauung	die
Scheich	der
Antibiotikum	das
Ausgrabung	die
ISDN	das
Regulierung	die
Mallorca	das
Schall	der
Zylinder	der
Fleischer	der
Manufaktur	die
Kolumne	die
Verschnaufpause	die
Wicht	der
Jongleur	der
Vorgeschmack	der
Spuk	der
Entgleisung	die
Promenade	die
Mythologie	die
Anpfiff	der
Komma	das
Operette	die
Strudel	der
Schluck	der
Horde	die
Anreise	die
Patriarchat	das
Klippe	die
Speer	der
Lappen	der
Marxismus	der
Sibylle	die
Uneinigkeit	die
Hecke	die
Stecher	der
Gilde	die
Sprint	der
Obrigkeit	die
Vorschub	der
Geier	der
Statist	der
Indikator	der
Rezension	die
Wachsamkeit	die
Internat	das
Schaufel	die
Verkleinerung	die
Zitrone	die
Pantomime	die
Vokabel	die
Bassist	der
Zigarre	die
Lake	die
Aspirant	der
Seide	die
Dickicht	das
Bistro	das
Relevanz	die
Inspiration	die
Gymnasiast	der
Beherrschung	die
Achsel	die
Zuordnung	die
Begnadigung	die
Verstrickung	die
Vorwarnung	die
Betriebsamkeit	die
Bitterkeit	die
Etwas	das
Obhut	die
Knick	der
Zwist	der
Benennung	die
Base	die
Hingabe	die
Aggregat	das
Mekka	das
Reproduktion	die
Inferno	das
Lux	das
Bresche	die
Belagerung	die
Verehrung	die
Hypothek	die
Krater	der
Suspendierung	die
Made	die
Unwahrheit	die
Verharmlosung	die
Aura	die
Zentralismus	der
Schnecke	die
Schlagzeuger	der
Rebe	die
Offenbarung	die
Matinee	die
Sachlichkeit	die
Schinken	der
Einvernehmen	das
Simulator	der
Wiederkehr	die
Fuhre	die
Anstiftung	die
Slowene	der
Zusicherung	die
Tauziehen	das
Gefolge	das
Skrupel	der
Locke	die
Mitbewohner	der
Kitzel	der
Diskrepanz	die
Repressalie	die
Werdegang	der
Lachs	der
Sonde	die
Busen	der
Ungeheuer	das
Abspaltung	die
Augenwischerei	die
Kollaborateur	der
Kaschmir	der
Wegweiser	der
Umarmung	die
Vandalismus	der
Aussehen	das
Sprit	der
Patriarch	der
Hemmnis	das
Tyrann	der
Antlitz	das
Zisterne	die
Karfreitag	der
Nachschub	der
Antike	die
Ausgestaltung	die
Unterwerfung	die
Durchfall	der
Pranger	der
Jenseits	das
Zession	die
Ameise	die
Fischen	das
Molkerei	die
Entschiedenheit	die
Badener	der
Pizza	die
Nachdenklichkeit	die
Tester	der
Zopf	der
Glaser	der
Anachronismus	der
Gepflogenheit	die
Einsetzung	die
Kegel	der
Kleber	der
Abfertigung	die
Vorrichtung	die
Verschmelzung	die
Evolution	die
Juwel	das
Abstecher	der
Wachs	das
Reizung	die
Mimik	die
Adoption	die
Umkehrung	die
Refrain	der
Zwielicht	das
Ausspruch	der
Hering	der
Nigerianer	der
Gigant	der
Auswanderer	der
Somalier	der
Koller	der
Messias	der
Depp	der
Cafeteria	die
Friese	der
Kutter	der
Beugung	die
Kamel	das
Anteilnahme	die
Lotterie	die
Raserei	die
Vergebung	die
Blindheit	die
Tuberkulose	die
Abdeckung	die
Beantwortung	die
Wedel	der
Abflug	der
Hopfen	der
Vorkommen	das
Nitrat	das
Relief	das
Kratzer	der
Megaphon	das
Strophe	die
Hinterlassenschaft	die
Durchblick	der
Allerlei	das
Raster	das
Klingel	die
Beweglichkeit	die
Anatolien	das
Sammelsurium	das
Techno	der
Marihuana	das
Klee	der
Einfachheit	die
Granit	der
Bedenkzeit	die
Therme	die
Voraussage	die
Projektor	der
Puzzle	das
Legion	die
Elektriker	der
Urheber	der
Banner	das
Heimkehr	die
Sinnlichkeit	die
Falte	die
Schlegel	der
Esche	die
Wichtigkeit	die
Synode	die
Rabbiner	der
Dynastie	die
Laudatio	die
Bissen	der
Henker	der
Leasing	das
Vorherrschaft	die
Moos	das
Auslage	die
Silhouette	die
Entertainer	der
Pragmatiker	der
Garnitur	die
Zement	der
Gefolgschaft	die
Freiwilligkeit	die
Rumpf	der
Lotse	der
Verminderung	die
Schuppe	die
Meuterei	die
Routinier	der
Manege	die
Kreation	die
Regatta	die
Vordenker	der
Bequemlichkeit	die
Objektiv	das
Alp	der
Lernen	das
Traurigkeit	die
Leuchter	der
Zuteilung	die
Philharmonie	die
Umsturz	der
Rezensent	der
Omen	das
Ober	der
Parabel	der
Spalier	das
Echtheit	die
Requiem	das
Blende	die
Deklaration	die
Swing	der
Aussperrung	die
Surfer	der
Aufmachung	die
Trunkenheit	die
Kalk	der
Erneuerer	der
Semit	der
Ungemach	das
Fetzen	der
Protektionismus	der
Anspannung	die
Scholle	die
Ren	das
Winde	die
Anthologie	die
Informatiker	der
Sklaverei	die
Vermischung	die
Laser	der
Zwiebel	die
Fuge	die
Sterilisation	die
Verfehlung	die
Beteuerung	die
Inbegriff	der
Malaria	die
Verwunderung	die
Applikation	die
Katalonien	das
Ausdauer	die
Gerichtsbarkeit	die
Nickel	das
Unterschlagung	die
Lot	das
Krim	die
Nudel	die
Schwur	der
Sierra	die
Sultan	der
Benzol	das
Larve	die
Zwiespalt	der
Kostbarkeit	die
Pamphlet	das
Mechanik	die
Erbschaft	die
Attest	das
Begebenheit	die
Wehe	die
Besteck	das
Hanf	der
Steak	das
Drechsler	der
Kastanie	die
Regung	die
Auswuchs	der
Klammer	die
Dramaturg	der
Nachahmung	die
Reglement	das
Giebel	der
Fossil	das
Unwissenheit	die
Chlor	das
Schmaus	der
Beisammensein	das
Mathematiker	der
Halbierung	die
Muskulatur	die
Verleiher	der
Bevormundung	die
Fabrikant	der
Enthusiast	der
Erkennung	die
Pseudonym	das
Kot	der
Akquisition	die
Pinguin	der
Kaugummi	der
Angesicht	das
Befestigung	die
Tory	der
Agitation	die
Monteur	der
Dankbarkeit	die
Gleichung	die
Mexikaner	der
Pauke	die
Einwilligung	die
Birke	die
Kanon	der
Programmierer	der
Steher	der
Korsett	das
Veruntreuung	die
Psychotherapie	die
Hacke	die
Kristall	der
Voranschlag	der
Kommerzialisierung	die
Pfeifer	der
Schwager	der
Populist	der
Philharmoniker	der
Vase	die
Accessoire	das
Aufdruck	der
Abwurf	der
Verarmung	die
Orkan	der
Papagei	der
Kanzel	die
Gaul	der
Mief	der
Verlassen	das
Belastbarkeit	die
Buchhandlung	die
Radius	der
Nachtrag	der
Vorbote	der
Fantasie	die
Konstrukteur	der
Gardist	der
Bandage	die
Dicke	der
Pappel	die
Kollekte	die
Schwalbe	die
Auswanderung	die
Substitution	die
Klatsche	die
Komiker	der
Zersplitterung	die
Rheinland	das
Zukauf	der
Angolaner	der
Finanzier	der
Idealist	der
Fischerei	die
Optimierung	die
Population	die
Unmenge	die
Afghane	der
Vorkenntnis	die
Erarbeitung	die
Raffinesse	die
Ermutigung	die
Spray	der
Demagogie	die
Bug	der
Bepflanzung	die
Protestant	der
Leim	der
Wucher	der
Schlichtung	die
Weiblichkeit	die
Lehm	der
Vorstufe	die
Begehrlichkeit	die
Namensgebung	die
Schaukel	die
Verwahrung	die
Verabredung	die
Schlitz	der
Herrlichkeit	die
Police	die
Dackel	der
Hengst	der
Psychotherapeut	der
Schmelz	der
Liquidation	die
Beraubung	die
Verschlag	der
Argwohn	der
Grauen	das
Entmilitarisierung	die
Este	der
Mutation	die
Kalifornier	der
Henne	die
Roller	der
Teenager	der
Lehne	die
Stanze	die
Apathie	die
Parterre	das
Riemen	der
Ricke	die
Widerruf	der
Auslese	die
Schanze	die
Kleinod	das
Gefilde	das
Bedeckung	die
Stachel	der
Pony	das
Cockpit	das
Feinheit	die
Gurt	der
Besoldung	die
Tinte	die
Tastatur	die
Frustration	die
Konglomerat	das
Ganove	der
Pensum	das
Erniedrigung	die
Kreatur	die
Abschottung	die
Assekuranz	die
Saldo	der
Pessimist	der
Prophezeiung	die
Abenteurer	der
Monokultur	die
Transit	der
Kartierung	die
Attrappe	die
Wechsler	der
Rappe	der
Krematorium	das
Spezialisierung	die
Verteiler	der
Kolloquium	das
Erstaunen	das
Hausse	die
Lethargie	die
Korsika	das
Ahn	der
Vertraulichkeit	die
Haitianer	der
Beeinflussung	die
Zentralisierung	die
Buckel	der
Leserschaft	die
Trilogie	die
Chauvinismus	der
Schiffer	der
Forelle	die
Geologe	der
Herold	der
Linderung	die
Erprobung	die
Plantage	die
Formaldehyd	das
Tablett	das
Inventur	die
Kolumbianer	der
Marder	der
Fortbildung	die
Luke	die
Dekor	das
Fremdheit	die
Hummel	die
Reliquie	die
Psychose	die
Streckung	die
Besonnenheit	die
Spital	das
Heu	das
Lama	das
Radikalisierung	die
Partisan	der
Tanne	die
Geometrie	die
Anlehnung	die
Elch	der
Animation	die
Turnen	das
Trompeter	der
Erz	das
Garnison	die
Walze	die
Salamander	der
Vorwahl	die
Spinne	die
Brut	die
Hindu	der
Sterblichkeit	die
Abmarsch	der
Lebendigkeit	die
Profilierung	die
Vorfreude	die
Bure	der
Bevorzugung	die
Duett	das
Marmor	der
Niederschlagung	die
Dosierung	die
Auflistung	die
Drehung	die
Technokrat	der
Dreher	der
Strapaze	die
Ferkel	das
Knut	der
Puste	die
Charakterisierung	die
Arznei	die
Kies	der
Langsamkeit	die
Macke	die
Diele	die
Nomade	das
Verruf	der
Sprinter	der
Schwemme	die
Entmachtung	die
Observation	die
Restauration	die
Eroberer	der
Etikette	die
Injektion	die
Befangenheit	die
Verehrer	der
Schnitzel	der
Bausch	der
Parasit	der
Mumie	die
Gestalter	der
Schelm	der
Stelldichein	das
Samba	der
Lilie	die
Videothek	die
Kasino	das
Plasma	das
Primus	der
Unrat	der
Germane	der
Bekanntgabe	die
Matador	der
Salzburg	das
Kakao	der
Puls	der
Finesse	die
Kinn	das
Machwerk	das
Mysterium	das
Brezel	die
Proletariat	das
Bewirtung	die
Maximum	das
Geleit	das
Verzeihung	die
Eindeutigkeit	die
Tarnung	die
Entflechtung	die
Tirade	die
Nachschlagewerk	das
Bonze	der
Perversion	die
Vorleistung	die
Bluter	der
Internationalisierung	die
Kommunique	das
Turbine	die
Schizophrenie	die
Nil	der
Unterlassung	die
Provokateur	der
Chronologie	die
Reifen	der
Anfeindung	die
Kolumnist	der
Staude	die
Schonfrist	die
Ebbe	die
Tupfer	der
Schleicher	der
Nelke	die
Katholizismus	der
Quark	das
Abpfiff	der
Faxe	die
Konfession	die
Demoskop	der
Bildhauer	der
Gips	der
Interviewer	der
Saturn	der
Klatsch	der
Kaviar	der
Klinke	die
Aufforstung	die
Vegetation	die
Zange	die
Degen	der
Inanspruchnahme	die
Schuppen	der
Brauchtum	das
Zeppelin	der
Schurz	der
Beule	die
Bildnis	das
Eigenheit	die
Voyeur	der
Ausgewogenheit	die
Tang	der
Erleuchtung	die
Genesung	die
Sarkasmus	der
Lanze	die
Mutterschaft	die
Dekade	die
Floh	der
Versager	der
Tischler	der
Paarung	die
Besiedlung	die
Sold	der
Prise	die
Mime	der
Fries	der
Marmelade	die
Bollwerk	das
Galle	die
Ablenkung	die
Styropor	das
Politisierung	die
Absenkung	die
Nutte	die
Wolga	die
Wanze	die
Heftchen	das
Marxist	der
Sextett	das
Leiste	die
Schwingung	die
Toskana	die
Vorbestellung	die
Replik	die
Fetisch	der
Taktiker	der
Wange	die
Obdach	das
Ekstase	die
Chiffre	die
Anfechtung	die
Separatismus	der
Gesamtheit	die
Aroma	das
Destabilisierung	die
Osterei	das
Flocke	die
Zyniker	der
Nabel	der
Feigling	der
Intonation	die
Implantat	das
Mikroskop	das
Schildchen	das
Ruderer	der
Oldtimer	der
Vereinheitlichung	die
Professionalisierung	die
Entwertung	die
Individualist	der
Quadratur	die
Hupe	die
Planetarium	das
Merkur	der
Umschreibung	die
Tauglichkeit	die
Dilettantismus	der
Beschaffenheit	die
Unze	die
Vorhaltung	die
Beichte	die
Dessert	das
Linse	die
Acryl	das
Kolben	der
Bewahrung	die
Nieselregen	der
Vertagung	die
Spring	die
Brie	der
Jockey	der
Affekt	der
Abgesang	der
Mosaik	das
Model	das
Reiberei	die
Gesteck	das
Einlassung	die
Entgegenkommen	das
Pendel	das
Layout	das
Feldwebel	der
Untat	die
Rute	die
Unionist	der
Feigheit	die
Fratze	die
Jordanier	der
Bummler	der
Rast	die
Bestrahlung	die
Walker	der
Alphabet	das
Verschleppung	die
Bumerang	der
Zuwiderhandlung	die
Allegorie	die
Enzym	das
Konservator	der
Matsch	der
Serum	das
Greis	der
Valuta	die
Fanatismus	der
Taifun	der
Muse	die
Nashorn	das
Schminke	die
Verstimmung	die
Lausitz	die
Legislative	die
Heiligtum	das
Kumpan	der
Verquickung	die
Tusch	der
Dur	das
Copyright	das
Asthma	das
Humanismus	der
Orgasmus	der
SOS	das
Befreier	der
Diabetes	die
Handgreiflichkeit	die
Dezibel	das
Fetischist	der
Statik	die
Patrone	die
Spinnerei	die
Assimilation	die
Polo	das
Epos	das
Frevel	der
Mineral	das
Salto	der
Vorraum	der
Befruchtung	die
Chilene	der
Glut	die
Abberufung	die
Surrealismus	der
Provision	die
Konzil	das
Frauchen	das
Niger	der
Hasser	der
Plateau	das
Winzling	der
Schablone	die
Bastler	der
Karpfen	der
Fehde	die
Unikat	das
Negativ	das
Weingarten	der
Referenz	die
Polarisierung	die
Heiligabend	der
Insulin	das
Schnitzer	der
Heiligkeit	die
Entsorger	der
Vereitelung	die
Erwerber	der
Verkabelung	die
Paradigma	das
Resozialisierung	die
Rippe	die
Edwin	der
Gaukler	der
Nachtigall	die
Flirt	der
Achtziger	der
Schlacke	die
Suizid	der
Theologe	der
Zwinger	der
Befriedung	die
Aktualisierung	die
Bungalow	der
Tandem	das
Mischling	der
Gendarmerie	die
Oratorium	das
Moped	das
Zweifler	der
Gemurmel	das
Archivar	der
Rodung	die
Lenkung	die
Havarie	die
Eifersucht	die
Freiberufler	der
Vorschau	die
Audienz	die
Versiegelung	die
Schieber	der
Vereinnahmung	die
Refugium	das
Untertan	der
Vampir	der
Bremser	der
Ausrottung	die
Libretto	das
Stute	die
Marionette	die
Statur	die
Hefe	die
Ausleihe	die
Schreier	der
Zerrung	die
Beschlag	der
Stipendiat	der
Konservatorium	das
Zerrissenheit	die
Unwille	der
Kreta	das
Legierung	die
Blackout	der
Gespinst	das
Tiegel	der
Diskretion	die
Hammel	der
Numerus	der
Gauner	der
Fibel	die
Abweichler	der
Sandale	die
Reputation	die
Knolle	die
Biest	das
Kralle	die
Cabrio	das
Konfiguration	die
Troika	die
Steppe	die
Messerstecherei	die
Vorvertrag	der
Verlockung	die
Harmonika	die
Individualismus	der
Allergiker	der
Korken	der
Verzierung	die
Finalist	der
Turnus	der
Terrier	der
Schnabel	der
Heuchler	der
Matt	das
Greif	der
Joker	der
Denunziant	der
Terminologie	die
Schlichtheit	die
Ministrant	der
Silbe	die
Stapler	der
Groll	der
Satan	der
Raps	der
Begutachtung	die
Diabetiker	der
Zucken	das
Nachruf	der
Psychoanalytiker	der
Zustellung	die
Sarkophag	der
Schlachtung	die
Teleskop	das
Entsprechung	die
Speicherung	die
Syndikat	das
Faible	das
Trance	die
Scheide	die
Programmierung	die
Bankett	das
Fraktur	die
Sputnik	der
Benachrichtigung	die
Internationalismus	der
Nacktheit	die
Klarinette	die
Reglementierung	die
Renaturierung	die
Waffel	die
Inquisition	die
Katechismus	der
Verbannung	die
Entbindung	die
Sichel	die
Koordinate	die
Opium	das
Meuterer	der
Dekadenz	die
Germanistik	die
Kropf	der
Phobie	die
Fatalismus	der
Individualisierung	die
Andalusien	das
Spange	die
Whisky	der
Grafschaft	die
Krake	der
Beurlaubung	die
Gerste	die
Anrechnung	die
Zauberei	die
Vordruck	der
Kelch	der
Kranich	der
Dilettant	der
Widder	der
Benedikt	der
Ballen	der
Reiniger	der
Kutscher	der
Reformation	die
Bewacher	der
Schlamassel	das
Sippe	die
Skat	der
Tadel	der
Cousin	der
Ocker	das
Modem	das
Harfe	die
Charakteristikum	das
Vikar	der
Autodidakt	der
Huldigung	die
Automatik	die
Transaktion	die
Wildnis	die
Projektil	das
Aufkauf	der
Kontor	das
Scherge	der
Typhus	der
Propagandist	der
Antiquariat	das
Mandel	die
Jaguar	der
Liaison	die
Kegler	der
Verlogenheit	die
Burgund	das
Gerippe	die
Zander	der
Schlesier	der
Fabel	die
Klopfen	das
Zersetzung	die
Atheist	der
Hegemonie	die
Mosambikaner	der
Faulheit	die
Durchlauf	der
Kopplung	die
Sanatorium	das
Wertigkeit	die
Amme	die
Rendezvous	das
Liturgie	die
Durchmarsch	der
Unachtsamkeit	die
Schnickschnack	der
Trottel	der
Rinde	die
Sortierung	die
Amputation	die
Diaspora	die
Schneiderei	die
Ungenauigkeit	die
Trommler	der
Neider	der
Sorbe	die
Trog	der
Pudel	der
Diakonie	die
Braue	die
Suggestion	die
Karikaturist	der
Buchen	das
Schnurrbart	der
Abruf	der
Zenit	der
Kuppe	die
Zink	das
Indiskretion	die
Spaten	der
Frager	der
Veranlagung	die
Helligkeit	die
Esprit	der
Expressionismus	der
Ventilator	der
Balg	der
Vorladung	die
Intuition	die
Schurke	der
Hochsprung	der
Ermahnung	die
Dock	das
Zeiger	der
Limes	der
Wiesel	der
Quintessenz	die
Romanze	die
Katharsis	die
Biologe	der
Konversation	die
Robbe	die
Deregulierung	die
Bohrer	der
Portier	der
Romantiker	der
Hecht	der
Rauschen	das
Speisung	die
Zobel	der
Stecker	der
Gletscher	der
Charge	die
Pascal	das
Pizzeria	die
Vegetarier	der
Karate	das
Verwerfung	die
Ermessen	das
Moralist	der
Fregatte	die
Reptil	das
Hausmann	der
Dissertation	die
Deeskalation	die
Vollstrecker	der
Trabant	der
Milde	die
Satiriker	der
Akribie	die
Junker	der
Rune	die
Kosmonaut	der
Opportunist	der
Most	der
Aushang	der
Gestirn	das
Ungeheuerlichkeit	die
Intellekt	der
Kiwi	die
Choral	der
Entdecker	der
Primat	der
Unannehmlichkeit	die
Airbag	der
Verengung	die
Unfriede	der
Bridge	das
Kork	der
Absprung	der
Steigung	die
Hippie	der
Glosse	die
Ion	das
Streuung	die
Knoblauch	der
Gelage	das
Torheit	die
Verunglimpfung	die
Ungeziefer	das
Verzinsung	die
Stechen	das
Schwamm	der
Peiniger	der
Vereidigung	die
Thronfolger	der
Mitgift	die
Abbrecher	der
Juwelier	der
Meineid	der
Mystik	die
Rowdy	der
Treck	der
Ethos	das
Erfrischung	die
Regent	der
Brise	die
Watte	die
Liechtenstein	das
Humus	der
Pflanzer	der
Stimmigkeit	die
Anthropologie	die
Dynamit	das
Scheiterhaufen	der
Dressur	die
Schenkung	die
Paradoxon	das
Tick	der
Stippvisite	die
Bieter	der
Verknappung	die
Erledigung	die
Schuldigkeit	die
Flinte	die
Verherrlichung	die
Systematik	die
Erwerbung	die
Abtei	die
Signatur	die
Tibeter	der
Rapport	der
Postulat	das
Teilhaber	der
Kommentierung	die
Wicke	die
Posaune	die
Ansporn	der
Heftigkeit	die
Intermezzo	das
Meute	die
Staffelung	die
Arsen	das
Maskottchen	das
Schnipsel	das
Billard	das
Schwefel	der
Beschriftung	die
Automatisierung	die
Auslagerung	die
Fingerzeig	der
Instandhaltung	die
Litanei	die
Melder	der
Rezeptur	die
Strenge	die
Schweinchen	das
Beigeschmack	der
Reiher	der
Sittich	der
Plagiat	das
Abgeschiedenheit	die
Mofa	das
Gegenseitigkeit	die
Geschwader	das
Gendarm	der
Konzentrat	das
Manie	die
Zusammentreffen	das
Scherflein	das
Vorplanung	die
Konstitution	die
Orakel	das
Bazillus	der
Haltbarkeit	die
Distel	die
Interaktion	die
Kenianer	der
Abhandlung	die
Apparatur	die
Stutzer	der
Konjunktiv	der
Galgen	der
Sieb	das
Galopp	das
Besessenheit	die
Biber	der
Verstaatlichung	die
Verstehen	das
Klerus	der
Spike	der
Pickel	der
Potpourri	das
Knirps	der
Lauge	die
Kantate	die
Jogger	der
Friesland	das
Sporn	der
Amok	der
Insulaner	der
Puffer	der
Sezession	die
Voruntersuchung	die
Persiflage	die
Kommode	die
Grafiker	der
Mongolei	die
Lichtung	die
Strafbarkeit	die
Entlohnung	die
Versprecher	der
Vitamin	das
Weilchen	das
Entscheider	der
Reminiszenz	die
Senf	der
Wehmut	die
Balsam	der
Leckerbissen	der
Monopolist	der
Kuli	der
Einfalt	die
Massiv	das
Anreicherung	die
Verpuffung	die
Narkose	die
Ghanaer	der
Riesling	der
Nichte	die
Miniatur	die
Rain	der
Verleugnung	die
Klaue	die
Positiv	das
Filet	das
Schliff	der
Cambridge	das
Fruchtbarkeit	die
Demut	die
Mitbringsel	das
Komet	der
Psalm	der
Sakko	das
Erstarrung	die
Tunte	die
Advokat	der
Fasten	das
Anorak	der
Schmarotzer	der
Schmalz	der
Schlund	der
Serge	die
Fechter	der
Eskapade	die
Annexion	die
Falter	der
Mississippi	der
Libyer	der
Bulletin	das
Spind	der
Trichter	der
Verfremdung	die
Kambodschaner	der
Slang	der
Jalousie	die
Wahrzeichen	das
Schah	der
Abrede	die
Verdreifachung	die
Katakombe	die
Militarismus	der
Trockner	der
Paranoia	die
Relegation	die
Cousine	die
Butler	der
Ural	der
Kerker	der
Konditor	der
Mol	das
Infanterist	der
Umlegung	die
Seiler	der
Auffahrt	die
Nachforschung	die
Gesundung	die
Amalgam	das
Kaleidoskop	das
Ansteckung	die
Knarre	die
Bagatelle	die
Stuck	der
Maestro	der
Kelte	der
Guthaben	das
Leier	die
Jux	der
Phalanx	die
Aushilfe	die
Inkarnation	die
Rikscha	die
Pritsche	die
Lader	der
Puff	der
Verrohung	die
Torf	der
Schmiere	die
Brikett	das
Genetik	die
Prokurist	der
Impfstoff	der
Didaktik	die
Striptease	der
Anrainer	der
Bezuschussung	die
Wonne	die
Anatomie	die
Etablierung	die
Barde	die
Atoll	das
Unsterblichkeit	die
Kollektion	die
Politesse	die
Horoskop	das
Lid	das
Arithmetik	die
Trott	der
Zepter	das
Schleifer	der
Administrator	der
Akrobat	der
Plausch	der
Geschicklichkeit	die
Rassel	die
Vehemenz	die
Frische	die
Arbeiterschaft	die
Stollen	der
Toxikologe	der
Konservierung	die
Meise	die
Zweideutigkeit	die
Negation	die
Saum	der
Scharte	die
Koexistenz	die
Abmeldung	die
Kletterer	der
Entgiftung	die
Evangelist	der
Wahrhaftigkeit	die
Veranda	die
Zuruf	der
Autopsie	die
Mohn	der
Barmherzigkeit	die
Verschleierung	die
Bekanntmachung	die
Nessel	die
Artikulation	die
Fresko	das
Exotik	die
Korrektheit	die
Manifestation	die
Berechenbarkeit	die
Babysitter	der
Weitsprung	der
Bronchitis	die
Erwiderung	die
Essig	der
Salbe	die
Coupon	der
Giraffe	die
Quader	der
Ablage	die
Tohuwabohu	das
Superintendent	der
Deformation	die
Installateur	der
Gorilla	der
Aneignung	die
Sudanese	der
Schlepptau	das
Symmetrie	die
Anbetung	die
Sardinien	das
Abstufung	die
Flame	der
Schlinge	die
Abspann	der
Anthropologe	die
Imker	der
Unentschlossenheit	die
Neptun	der
Messen	das
Geheul	das
Blasphemie	die
Basilika	die
Provinzialismus	der
Adjektiv	das
Fittich	die
Motorisierung	die
Repatriierung	die
Methodik	die
Karosserie	die
Abdichtung	die
Sturheit	die
Diakon	der
Behebung	die
Triptychon	das
Reorganisation	die
Jacht	die
Gleichnis	das
Beharrlichkeit	die
Kniff	der
Pflegschaft	die
Schnuller	der
Stigma	das
Melone	die
Nikotin	das
Wischer	der
Klempner	der
Schrein	der
Bibliothekar	der
Vorarbeiter	der
Kubus	der
Stornierung	die
Brandung	die
Tantieme	die
Verbeugung	die
Rosine	die
Bretagne	die
Kruste	die
Wade	die
Teer	der
Koks	der
Liedchen	das
Vati	der
Implikation	die
Verdrehung	die
Machete	die
Monotonie	die
Garbe	die
Obolus	der
Studentenschaft	die
Grundsteinlegung	die
Buddhismus	der
Retourkutsche	die
Aufpreis	der
Klecks	der
Geilheit	die
Kriminalist	der
Anzahlung	die
Exhibitionist	der
Elle	die
Lunte	die
Anfertigung	die
Kommunion	die
Weltanschauung	die
Exponent	der
Spreu	die
Verlangsamung	die
Efeu	der
Vorhut	die
Oxford	das
Multiplikator	der
Astronom	der
Kalorie	die
Hamster	der
Sunnit	der
Abweg	der
Ufo	das
Internierung	die
Cluster	das
Gosse	die
Passat	der
Diktion	die
Liane	die
Bereitstellung	die
Riecher	der
Vertuschung	die
Picknick	das
Kaff	das
Bluff	der
Lebkuchen	der
Mentor	der
Vorrecht	das
Beschlagnahmung	die
Lagune	die
Ausflucht	die
Malteser	der
Amin	das
Exkurs	der
Vorfinanzierung	die
Aphorismus	der
Perspektivlosigkeit	die
Durchsatz	der
Entladung	die
Synchronisation	die
Umtrunk	der
Drogerie	die
Schilf	das
Bastard	der
Psychopath	der
Ochse	der
Pomp	der
Demagoge	der
Kellerei	die
Demobilisierung	die
Wohnmobil	das
Aufmacher	der
Unzahl	die
Aufgeschlossenheit	die
Grimasse	die
Witwer	der
Auswechslung	die
Bosheit	die
Scheitel	der
Relativierung	die
Rubin	der
Aufbewahrung	die
Huf	der
Limonade	die
Anrede	die
Derwisch	der
Nistkasten	der
Strahler	der
Pfote	die
Gleichzeitigkeit	die
Skandinavier	der
Rotte	die
Guillotine	die
Ulme	die
Einstand	der
Roulette	das
Verschwiegenheit	die
Bravour	die
Vorzimmer	das
Kotze	die
Hast	die
Militarisierung	die
Esperanto	das
Schwank	der
Stilisierung	die
Schnulze	die
Installierung	die
Megahertz	das
Pore	die
Platane	die
Elektrifizierung	die
Dessous	das
Unvernunft	die
Finte	die
Brillanz	die
Impressum	das
Brunst	die
Ellbogen	der
Schneid	der
Garn	das
Steiermark	die
Zwei	die
Beschwichtigung	die
Stakkato	das
Malz	das
Indonesier	der
Unberechenbarkeit	die
Zierde	die
Vorprogramm	das
Atmung	die
Pier	die
Kanu	das
Serviette	die
Schlittschuh	der
Entbehrung	die
Orchidee	die
Paste	die
Askese	die
Phosphat	das
Gebinde	das
Zaum	der
Fabrikat	das
Auflauf	der
Apologet	der
Fleckchen	das
Epilog	der
Transvestit	der
Summer	der
Unkenntlichkeit	die
Moldau	die
Schlick	der
Gigantomanie	die
Judo	das
Sperma	das
Ikonographie	die
Laken	das
Fanfare	die
Sternchen	das
Konfirmand	der
Liege	die
Versehen	das
Aufpasser	der
Verglasung	die
Yankee	der
Teneriffa	das
Naturalismus	der
Vertrautheit	die
Peruaner	der
Traktat	das
Showmaster	der
Anger	der
Avantgardist	der
Kadett	der
Belustigung	die
Baske	der
Enthaltsamkeit	die
Viadukt	das
Arkade	die
Atrium	das
Rugby	das
Milderung	die
Erbse	die
Klause	die
Widerhall	der
Kontamination	die
Puck	der
Aufweichung	die
Kauz	der
Widerwille	der
Profession	die
Puma	der
Findigkeit	die
Lerche	die
Schotter	der
Verpachtung	die
Altertum	das
Husten	der
Kruzifix	das
Verschulden	das
Sprenger	der
Verallgemeinerung	die
Wimper	die
Anmietung	die
Bit	das
Rekrutierung	die
Bolzen	der
Visitation	die
Beduine	der
Entpolitisierung	die
Anmut	die
Getue	das
Schrumpfung	die
Kirmes	die
Querulant	der
Aufrichtigkeit	die
Waagschale	die
Nachgeschmack	der
Garderobe	die
Dreistigkeit	die
Schrebergarten	der
Eingeweide	das
Smoking	der
Machbarkeit	die
Kelle	die
Ranch	die
Halluzination	die
Ausleihung	die
Chromosom	das
Punsch	der
Kassandra	der
Vermessung	die
Esoterik	die
Ketzer	der
Trust	der
Widmung	die
Boa	die
Metaphorik	die
Frack	der
Methan	das
Statiker	der
Zuschreibung	die
Umschuldung	die
Umsicht	die
Klugheit	die
Vorspeise	die
Koppel	das
Reprivatisierung	die
Ammoniak	das
Optimum	das
Abholung	die
Vollstreckung	die
Koppelung	die
Mammon	der
Girlande	die
Verzahnung	die
Controller	der
Masseur	der
Bajonett	das
Stickerei	die
Physiognomie	die
Safari	die
Muff	der
Mulde	die
Lava	die
Trenchcoat	der
Hypnose	die
Polonaise	die
Vollkommenheit	die
Begradigung	die
Travestie	die
Zionist	der
Gondel	die
Laib	das
Zebra	das
Intervall	das
Vormund	der
Hetzer	der
Adapter	der
Menstruation	die
Transistor	der
Motte	die
Antipathie	die
Vergeudung	die
Ausgliederung	die
Vereinzelung	die
Sorglosigkeit	die
Konkretisierung	die
Gaumen	der
Spielverderber	der
Verderb	der
Archipel	das
Befristung	die
Pflug	der
Flosse	die
Tuba	die
Ausruf	der
Schonzeit	die
Rhythmik	die
Kate	die
Penny	der
Slip	der
Knospe	die
Beschaulichkeit	die
Interimsregierung	die
Musterung	die
Vorahnung	die
Jungfrau	die
Kufe	die
Drill	der
Mausoleum	das
Peer	der
Teamwork	das
Desinfektion	die
Brennerei	die
Fessel	die
Sisyphusarbeit	die
Zionismus	der
Propeller	der
Kutte	die
Ornithologe	der
Kolonisation	die
Automation	die
Partizipation	die
Bestatter	der
Sichtung	die
Warze	die
Epizentrum	das
Mikrobe	die
Steinmetz	der
Patina	die
Pollen	der
Vorentwurf	der
Untermalung	die
Sakrament	das
Paternoster	der
Bariton	der
Blitzableiter	der
Universalismus	der
Jesuit	der
Kollektivierung	die
Pommern	das
Molch	der
Auflockerung	die
Unmenschlichkeit	die
Templer	der
Einengung	die
Neofaschismus	der
Casanova	der
Aufrechnung	die
Anwerbung	die
Tigris	der
Maskerade	die
Spritzer	der
Kindergarten	der
Spiritus	der
Spezifikation	die
Volt	das
Tran	der
Abtrennung	die
Vorland	das
Heizer	der
Zecke	die
Protz	der
Aufbesserung	die
Ausgeglichenheit	die
Firmament	das
Strolch	der
Vereinsamung	die
Infusion	die
Jasmin	der
Kannibalismus	der
Virtuose	der
Annullierung	die
Intensivierung	die
Implementierung	die
Pein	die
Pauker	der
Normandie	die
Herzogtum	das
Unvereinbarkeit	die
Vielschichtigkeit	die
Konsistenz	die
Mannequin	das
Whiskey	der
Wanderschaft	die
Klaviatur	die
Sattler	der
Amerikanismus	der
Pigment	das
Regeneration	die
Unbeweglichkeit	die
Setter	der
Realist	der
Kupplung	die
Sentenz	die
Sense	die
Unsitte	die
Iglu	das
Otter	der
Aschenputtel	das